#汉字	同音同调	同音异调
一	壹漪	以义移易
丁	盯叮	钉锭鼎定郑顶订
七	戚漆栖凄溪欺柒妻	泣迄畦稽脐只鳍气奇砌契企祈骑枝启旗歧起器乞棋弃汽齐其崎岂期
万	玩腕惋	顽娩碗宛丸豌完湾婉晚弯挽
丈	涨长帐胀杖仗账障	彰掌樟张章
三	参	散伞
上	赏尚晌	伤商裳汤
下	暇厦夏吓	虾狭洽匣挟峡侠瞎霞斜辖
不	埠步怖部布簿	捕补哺卜
与	域裕雨屿予玉愈尉育誉浴寓欲芋羽御狱郁豫预遇语吁谷宇喻	逾迂于愉渔榆娱鱼舆隅愚淤
丐	溉概盖钙	该改
丑		臭稠绸畴筹愁仇抽酬
专	砖	传撰赚转
且		怯切窃茄契
世	拭势逝室是使柿侍市士饰适誓试氏视恃示式识事释嗜	提匙施时屎驶拾狮实诗食什石十史射尸失硕虱蚀矢始师湿
丘	蚯龟秋	求仇球囚
丙	饼柄禀秉屏	冰兵病并
业	页咽夜叶射谒	爷野椰也冶
丛	从	聪葱囱匆
东	冬	冻栋董动懂洞
丝	司思斯撕嘶私	死食四饲伺肆似赐寺
两	俩	凉量谅粱晾良亮辆梁粮
严	炎颜阎延沿研癌盐言	淹谚咽唁演艳焰掩奄宴雁烟验殷衍燕堰眼厌砚
丧	桑	嗓
个	各	搁阁合革隔蛤胳鸽歌格戈割葛哥疙
中	种忠盅众衷重终钟仲	肿
丰	疯峰风封枫锋讽蜂	奉凤缝逢冯
串		传喘穿川
临	淋鳞琳邻林磷	凛赁吝躏
丸	玩完顽	万腕碗娩宛豌惋湾婉晚弯挽
丹	单耽担	弹淡胆石氮蛋旦但诞
为	卫薇位喂伪尉维胃未味违遗慰蔚微桅谓围唯危魏巍畏	委伟尾苇威偎萎纬
主	贮煮拄属嘱	助朱住注蛛猪柱筑术珠祝铸轴竹烛蛀诸逐驻株
丽	立吏犁厘黎狸梨砾雳痢璃隶沥离粒励厉力荔历莉篱漓例俐利栗	李礼理哩里鲤
举	矩沮	聚蛆居车具俱炬句锯局据菊拘鞠巨剧距橘拒驹惧足
乃	奶奈	耐
久	九酒韭灸纠玖	就舅揪鸠臼旧救疚究
么	夭哟腰吆要邀妖	侥摇耀药淆舀遥肴谣乐咬钥拗窑姚
义	腋邑逸艺肄掖亦意抑溢疫异役易忆翼衣益亿奕液毅译绎屹艾一议谊	夷疑医仪伊漪依已以倚椅乙遗移姨胰宜尾揖蛇蚁矣壹
之	只氏芝枝肢知织蜘支吱脂汁	址植治致制直窒掷征帜执稚志智挚值止纸趾职至秩置滞殖指识旨质酯
乌	于巫诬屋呜污恶	无务伍雾午吴舞勿梧五武芜悟亡蜈晤误物坞捂侮鹉
乍	栅炸诈	眨喳渣查扎闸
乎	呼忽戏	壶许沪互狐唬户胡护葫虎糊蝴弧湖
乏	阀伐法罚筏	发
乐	悦越阅勒垃岳肋说耀药粤跃要拗钥月	侥摇么哟夭淆腰遥舀肴谣咬吆约邀窑姚了妖
乒		苹萍平评屏坪冯瓶凭
乓	磅	旁胖膀螃庞
乔	桥侨瞧憔翘	巧窍峭锹跷撬壳俏鹊敲悄雀
乖		拐怪
乘	呈惩成城程诚承剩圣胜盛橙澄	称秤牲生绳升撑逞笙省甥声
乙	已	亿艺忆
九	久酒纠玖	就舅揪鸠臼旧救疚究
乞	起岂启稽	泣迄戚漆畦脐妻七只鳍气奇砌契凄企祈骑枝旗栖欺歧柒器棋弃汽齐其溪崎期
也	野冶	页咽爷夜业椰叶射谒
习	袭息媳昔惜熄席锡	悉熙厘畦徙戏隙西喜牺希膝栖吸洗携晰析系行夕犀稀溪嬉蟋细
乡	像橡相项向箱镶巷厢湘象香	想祥详享响翔降
买		迈埋麦脉卖
乱		卵峦
乳	女辱	蠕入如褥儒
了	燎料	撩聊疗缭辽寥潦僚嘹
了	辽
予	逾雨屿愉于榆鱼愚羽渔娱与舆隅语宇	愈浴淤狱豫遇谷喻域裕玉尉育誉寓欲御迂郁预吁芋
争	丁正征筝怔症狰睁挣蒸	政整郑证拯
事	拭势逝室是使柿侍市士世饰适誓试氏视恃示式识释嗜	提匙施时屎驶拾狮实诗食什石十史射尸失硕虱蚀矢始师湿
二	贰	尔耳饵而儿
于	逾予愉榆鱼巫诬乌屋愚恶渔娱舆隅呜污	屿无愈务伍雾浴午淤吴狱舞勿与豫梧五羽武语谷遇喻域裕雨芜玉育尉誉悟亡寓欲御迂蜈郁晤误物坞预捂侮鹉吁芋宇
于	逾予愉渔娱鱼榆舆隅愚	屿愈浴淤狱与豫遇羽语谷喻域裕雨玉尉育誉寓欲御迂郁预吁芋宇
亏	盔窥	傀葵魁愧溃
云	耘匀	晕酝陨允孕运蕴韵员
互	户沪护	壶许呼狐戏唬乎胡葫虎忽糊蝴弧湖
五	舞伍捂侮午鹉武	无于务雾巫诬乌吴勿梧呜污芜悟亡屋恶蜈晤误物坞
井	颈警景阱	兢惊径境竞荆茎靖京竟镜鲸经精睛静净劲敬更晶
亚	雅讶轧哑	牙压蚜鸭鸦呀涯衙押芽
些	歇	骇屉屑鞋挟蟹携谐楔斜邪懈械胁谢写协卸契泻解血
亡	蜈王无芜巫诬梧吴	旺于务伍雾望乌午网忘妄舞勿武五呜污枉悟屋恶往晤误物坞捂侮鹉汪
交	椒蕉娇胶焦礁教骄浇郊	矫侥搅狡轿叫觉绞饺角窖剿校脚较嚼缴
亥	骇害	孩咳还海
亦	腋邑逸艺肄掖意抑义溢疫异役易忆翼衣益亿奕液毅译绎屹艾一议谊	夷疑医仪伊漪依已以倚椅乙遗移姨胰宜尾揖蛇蚁矣壹
产	铲阐	馋单蝉搀缠掺
亩	姥姆母拇牡	幕募木慕暮沐目牧墓穆模睦
享	想响	像祥向箱镶巷详湘象降橡相项乡厢翔香
京	鲸兢惊精经睛荆茎更晶	颈径境竞静阱景净井劲靖警敬竟镜
亭	庭蜓廷停	厅艇听挺
亮	凉量谅晾辆	两俩良粮梁粱
亲	侵庆钦	勤秦倾卿情顷寝清请蜻晴青芹氢擒琴禽擎轻
人	仁儿任	赁认韧纫忍刃
亿	腋邑逸艺肄掖亦意抑义溢疫异役易忆翼衣益奕液毅译绎屹艾一议谊	夷疑医仪伊漪依已以倚椅乙遗移姨胰宜尾揖蛇蚁矣壹
什	提甚实舌食时硕石十蚀蛇拾射	拭匙势室施屎使柿侍驶饰涉誓狮氏诗恃示奢式史事赦释嗜适尸失逝是虱士舍市叶世赊摄试矢设社视识始师湿
仁	儿人任	赁认韧纫忍刃
仅	进尽紧锦劲谨禁浸近晋	津金斤巾今筋襟
仆	菩葡朴蒲脯	瀑浦谱暴铺圃普扑
仆	铺扑	瀑菩葡朴浦谱暴蒲圃普脯
仇	稠囚绸畴筹求愁球酬	臭蚯丑丘龟秋抽
今	津金斤巾禁浸筋襟	进尽锦紧劲仅谨近晋
介	届界解借诫戒芥	接节杰竭截揭阶皆街劫捷姊结洁姐
仍		扔
从	聪丛囱综纵匆葱	棕总踪宗
仑	轮抡伦论沦
仓	苍舱沧	藏
仔	紫宰籽子载滓	资滋栽自字姿在再吱灾咨
仗	丈涨长帐胀杖账障	彰掌樟张章
付	附妇赴傅赋富复咐父腹负副	辐浮缚符麸伏拂脯福斧俘袱甫夫敷芙蝠肤抚俯府辅幅服孵扶腐
仙	鲜先纤掀	嫌馅衔弦险腺线涎舷癣闲贤县咸现显陷限铣献宪
代	贷戴袋带大待逮怠	歹呆
令	另	岭领凌灵菱玲伶蛉铃陵龄翎零
以	尾椅乙蚁矣已倚	夷疑医艺肄意抑仪伊疫异漪忆翼衣益奕液毅屹艾一依议谊腋邑逸掖亦义溢遗移役易姨胰宜揖亿译绎蛇壹
仪	夷宜疑蛇遗一移姨胰谊	医艺肄意抑伊疫异漪忆翼衣益奕液毅屹艾依已议以倚腋邑逸掖椅乙亦义溢役易揖尾亿译绎蚁矣壹
们	门	闷
仰	痒氧养	阳羊鸯杨样扬秧殃央洋漾
仲	中种重众	忠盅肿衷终钟
件	践建溅鉴渐健荐监涧键舰间贱剑见箭	坚柬拣捡茧兼简尖检剪俭艰碱减煎歼肩奸
价	架稼嫁贾假驾	佳荚钾挟加家轧甲颊夏夹嘉茄
任	赁认韧纫人刃儿仁	忍
份	愤粪奋分忿	粉芬吩焚纷氛坟
仿	访纺	芳房妨放坊肪方防
企	泣器迄气弃砌汽契妻	戚稽畦漆脐七只鳍奇凄祈骑枝旗启栖欺起歧柒乞棋齐其溪崎岂期
伊	揖衣医依一壹漪	夷疑艺肄意抑仪疫异忆翼益奕液毅屹艾已议以倚谊腋邑逸掖椅乙亦义溢遗移役易姨胰宜尾亿译绎蛇蚁矣
伍	武舞捂侮午鹉五	无于务雾巫诬乌吴勿梧呜污芜悟亡屋恶蜈晤误物坞
伏	芙辐蝠浮福幅服缚俘袱符扶拂夫	妇赴腹麸付脯附赋斧父负甫敷傅咐肤抚俯府辅富复孵腐副
伐	阀乏法发罚筏
休	修羞	锈臭宿袖嗅秀朽绣
众	中种重仲	忠盅肿衷终钟
优	悠忧幽	佑尤由游友邮犹又油诱有幼右
伙	火	豁或和获货活祸霍惑
会	虫快筷诲块秽惠讳贿汇刽绘毁悔晦慧溃	恢茴堕回挥辉徽灰蛔
伞	散	三参
伟	委尾苇萎纬	为卫薇位喂伪尉维胃未味威违偎遗慰蔚微桅谓围唯危魏巍畏
传	撰船赚转	喘穿串砖专川
伤	商汤	上尚裳赏晌
伦	仑轮抡论沦
伪	为卫谓位尉喂胃未味遗慰蔚魏畏	委伟尾薇苇违维围威偎萎纬唯危微巍桅
伯	泊渤搏勃罢卜薄脖膊舶爸霸白柏耙博驳坝荸	八巴芭疤叭靶捌把播拔玻剥簸笆拨跋般吧扒跛菠
估	沽辜家雇咕告顾姑孤故固	股凸古鼓滑贾骨谷
伴	半扮拌绊办瓣	班板扳搬颁版般斑
伶	凌灵菱玲蛉铃陵龄翎零	岭另领令
伸	信绅申深参身呻	沈甚审慎婶肾渗神
伺	食厕四刺饲肆似赐次寺	死瓷私司丝词此思差斯慈雌撕祠辞嘶磁
似	食四饲伺肆赐寺	死司丝思斯撕嘶私
佃	店垫殿甸玷淀奠电惦	颠典点碘
但	诞弹石氮担蛋旦淡	单胆耽丹
位	为卫谓尉喂伪胃未味遗慰蔚魏畏	委伟尾薇苇违维围威偎萎纬唯危微巍桅
低	滴	抵嘀蒂嫡帝芽缔笛的弟递底第涤敌地
住	助注柱祝铸蛀驻	朱贮煮蛛主猪拄筑术珠属轴竹烛逐诸嘱株
佑	又诱有幼右	忧幽尤悠犹游由邮友油优
体		剔屉提涕梯啼惕剃替蹄堤题踢
何	合核盖和荷河禾盒褐	鹤喝吓呵贺赫
作	做坐凿昨座	左
佣	庸拥	泳蛹踊用咏勇永
佣	用	泳蛹踊拥咏勇庸永
佩	配沛	陪培赔坏胚
佳	加家夹嘉茄	荚钾挟价架稼甲颊夏嫁贾假驾
使	拭势逝室屎是柿侍市士世驶饰矢适誓试氏视恃示式史识事始释嗜	狮提匙实失时施诗什石食十虱蚀拾硕射师湿尸
侈	齿耻尺	翅匙斥驰迟池赤持吃嗤弛
例	立吏砾雳丽痢隶沥粒励厉力荔历莉俐利栗	李离礼犁厘理哩黎篱狸梨漓璃里鲤
侍	拭势逝室是使柿市士世饰适誓试氏视恃示式识事释嗜	提匙施时屎驶拾狮实诗食什石十史射尸失硕虱蚀矢始师湿
供	宫弓共攻蚣躬工公贡恭功红	巩矿拱汞
依	揖衣医伊一壹漪	夷疑艺肄意抑仪疫异忆翼益奕液毅屹艾已议以倚谊腋邑逸掖椅乙亦义溢遗移役易姨胰宜尾亿译绎蛇蚁矣
侠	狭匣洽挟暇峡霞斜辖	虾厦瞎下吓夏
侣	履屡旅娄缕铝吕	氯滤律绿虑驴率
侥	矫狡摇绞淆遥肴姚搅较饺角谣剿窑脚缴	轿叫窖咬椒夭药舀胶钥拗娇嚼么蕉哟腰焦教校礁郊交觉耀乐吆要邀骄浇妖
侦	诊珍榛斟针贞真	阵振枕震疹镇
侧	策册测厕	窄择泽贼则怎责
侨	桥瞧憔乔翘	巧窍峭锹跷撬壳俏鹊敲悄雀
侮	武舞伍捂午鹉五	无于务雾巫诬乌吴勿梧呜污芜悟亡屋恶蜈晤误物坞
侯	喉猴	候吼厚后
侵	亲钦	勤擒秦琴禽寝芹
便	辫辨辩遍变	偏片蝙篇翩扁匾边鞭编贬骗
促	错趋卒趣醋簇	粗
俄	噩愕遏额哑恶饿讹鳄鹅蛾扼	阿
俊	骏峻竣菌	窘君尊钧遵均龟军
俏	窍峭跷撬壳翘	巧桥侨锹瞧憔乔鹊敲悄雀
俐	立吏砾雳丽痢隶沥粒励厉力荔历莉例利栗	李离礼犁厘理哩黎篱狸梨漓璃里鲤
俗		缩速肃宿粟酥塑诉素苏溯
俘	芙辐蝠浮福幅服缚袱符扶伏拂夫	妇赴腹麸付脯附赋斧父负甫敷傅咐肤抚俯府辅富复孵腐副
保	宝堡饱	爆包刨暴薄雹苞豹褒抱报胞
信	衅呻绅申深参身芯伸	沈甚欣寻薪婶慎新辛审肾心渗锌神
俩	两	凉量谅粱晾良亮辆梁粮
俭	柬拣捡茧检简剪减碱	践尖建鉴歼健监涧键兼贱肩箭溅渐荐坚艰舰煎间件剑见奸
修	休羞	锈臭宿袖嗅秀朽绣
俯	腐斧父抚甫府辅脯	妇赴辐浮缚腹符麸伏拂付附赋福俘负袱夫芙敷傅蝠咐肤富复幅服孵扶副
俱	聚蛆沮居车具炬句锯据拘巨剧距拒驹惧足	鞠橘矩举局菊
俺		按案鞍庵暗氨岸安
倍	臂背贝被辈焙狈惫备	卑悲杯北碑
倒	道悼到稻盗岛导祷蹈捣	刀叨
倔	掘觉决角绝诀爵脚嚼
倘	淌躺	堂趟唐糖烫棠膛汤搪塘
候	厚后	侯猴吼喉
倚	尾椅乙蚁矣已以	夷疑医艺肄意抑仪伊疫异漪忆翼衣益奕液毅屹艾一依议谊腋邑逸掖亦义溢遗移役易姨胰宜揖亿译绎蛇壹
借	届界介解诫戒芥	接节杰竭截揭阶皆街劫捷姊结洁姐
借	辑即籍吃棘脊唧急戒嫉芥击级寂集及届圾界介解诫吉极疾	纪妓杰竭稽给截荠叽皆劫记洁几姐迹接既鲫基饥箕阶继奇济挤积寄畸冀骑讥节际绩激居街祭机结季剂系计揭技忌肌其捷己姊鸡期
倡	唱畅猖昌	场长偿厂常尝肠裳敞
倦	眷圈卷绢	鹃捐身
债	寨祭责	窄斋宅摘齐
值	植殖执职直质掷	址治致制脂窒只氏征织帜稚蜘之志智挚枝肢止纸趾至支秩吱置汁芝知滞指识旨
倾	氢卿顷轻擎情清蜻晴青	亲庆请
假	钾价稼甲夏嫁贾架驾	佳荚加挟家颊夹嘉茄
偎	委威萎	为卫薇位喂伪尉维胃未味违遗纬慰蔚微桅伟尾谓苇围唯危魏巍畏
偏	篇翩扁	片遍骗便
做	凿坐作座	昨左
停	庭蜓廷亭	厅艇听挺
健	践建溅鉴渐荐监件涧键舰间贱剑见箭	坚柬拣捡茧兼简尖检剪俭艰碱减煎歼肩奸
偶	藕呕	欧区殴鸥
偷		投头透
偿	场长常尝肠裳	唱昌厂畅倡敞猖
傀	归规瑰龟闺	葵跪鬼窥魁诡愧桂柜盔贵溃亏轨
傅	附妇赴赋富复咐父腹负副付	辐浮缚符麸伏拂脯福斧俘袱甫夫敷芙蝠肤抚俯府辅幅服孵扶腐
傍	蚌谤旁梆帮磅棒邦	膀绑榜
储	锄楚橱除处础厨雏	矗畜初触出
催	崔衰摧	悴翠脆粹
傲	澳懊奥拗	袄熬凹
傻		霎砂杀杉煞沙厦纱
像	橡相项向乡巷象	想祥箱镶厢详享响湘翔香降
僚	聊撩疗缭辽寥潦燎嘹	了料
僵	将浆姜江疆缰	桨酱蒋强匠讲奖降
僻	辟屁譬	否匹脾霹啤批坏被罢疲皮劈披
儒	如蠕	女入辱褥乳
儡	垒累蕾	勒泪擂雷类
儿	尔而二耳
儿	而	尔耳饵贰二
允	陨	晕酝孕云运蕴韵耘匀员
元	猿源辕原援缘园袁员圆	远宛渊愿怨冤鸳院
兄	凶匈胸汹	雄熊
充	冲	崇宠虫重
兆	赵罩召照	昭嘲找招爪朝着沼
先	鲜仙纤掀	嫌馅衔弦险腺线涎舷癣闲贤县咸现显陷限铣献宪
光		广逛
克	课可刻客	磕苛咳坷科蝌棵壳渴颗
免	冕紊问娩文闻勉缅	瘟棉吻眠蚊绵纹面温稳
兑	对队	堆
兔	吐	秃土凸徒涂图突屠途
党	档挡	铛裆荡当
兜	都	痘斗陡读逗蚪豆抖
兢	鲸经惊精睛荆茎京更晶	颈径境竞静阱景净井劲靖警敬竟镜
入	褥辱	女蠕如乳儒
全	泉卷拳权痊犬	劝圈券
八	巴扒捌笆芭疤吧叭	爸靶霸把伯耙罢拔跋坝
公	宫弓共攻蚣躬工供恭功红	拱汞巩贡矿
六	溜馏陆	刘铆流榴硫留瘤柳泵琉
兰	拦蓝澜篮栏	览懒榄缆烂揽滥
共	弓攻公工贡红供矿宫汞蚣躬巩恭功拱
关	官观棺冠	馆管惯贯罐灌
兴	腥星性姓猩杏幸	邢行型刑醒形
兵	冰	饼柄禀病并秉屏丙
其	激绩叽枝旗畦稽居鸡唧机脐歧几迹只鳍基饥箕棋奇肌积齐畸崎祈骑期讥	纪泣迄妓戚漆籍给荠即吃棘脊借记急妻嫉七既鲫级寂气集及继砌济契挤寄凄企冀吉际启辑栖祭欺季柒剂起击系计器乞弃技圾汽忌溪己岂极疾
具	聚巨剧距拒俱惧炬句锯据足	拘鞠蛆沮居车橘驹矩举局菊
典	碘点	店垫殿甸玷佃淀奠颠电惦
养	样痒氧仰漾	阳羊鸯杨扬秧殃央洋
兼	坚尖艰溅歼煎渐间监肩奸	践建鉴健涧拣捡键检碱贱箭柬简剪荐茧俭舰减见件剑
兽	售瘦授受寿	收首守手熟
冀	际纪妓荠祭季记剂系既计鲫继技济忌寄骑	叽稽给籍即吃棘脊唧借急几嫉迹基集级箕寂饥及奇挤积畸吉讥激绩辑居机击圾肌其己鸡期极疾
内		哪馁
冈	扛岗纲肛缸钢刚	港
册	策测侧厕
再	在载	仔灾宰栽
冒	贸茂帽貌	毛茅矛锚猫
冕	免勉缅娩	绵眠面棉
冗	茸	溶荣绒蓉榕熔容融
写	血	骇屉屑鞋挟蟹携谐楔歇斜邪懈械胁谢协卸契些泻解
军	均君钧龟	菌窘骏峻竣俊
农	浓脓	弄
冠	观惯官棺贯罐灌关	馆管
冤	宛渊鸳	远源猿辕原愿怨援缘园元袁院员圆
冬	东	冻栋董动懂洞
冯	苹萍平评缝逢屏坪瓶凭	丰疯奉峰风封枫乒凤锋讽蜂
冰	兵	饼柄禀病并秉屏丙
冲	充	崇宠虫重
决	掘倔觉角绝诀爵脚嚼
况	框旷眶矿	筐狂
冶	野也	页咽爷夜业椰叶射谒
冷		楞
冻	栋洞动	懂董东冬
净	径境竞静劲敬靖竟镜	颈兢惊鲸经精睛阱荆茎井警京更景晶
凄	戚漆栖溪欺柒妻七	泣迄畦稽脐只鳍气奇砌契企祈骑枝启旗歧起器乞棋弃汽齐其崎岂期
准		谆屯
凉	量谅粱晾良亮辆梁粮	两俩
凌	灵菱玲伶蛉铃陵龄翎零	岭另领令
减	柬拣捡茧检简俭剪碱	践尖建鉴歼健监涧键兼贱肩箭溅渐荐坚艰舰煎间件剑见奸
凑		臭操糙
凛		赁躏临淋鳞琳邻吝林磷
凝	拧狞柠宁	泞
几	激绩叽稽给居脊唧机迹基饥箕奇济挤积肌其畸己鸡期讥	纪妓即籍荠吃棘借急记嫉既鲫级集寂及继寄冀吉骑际辑祭季剂击系计技忌圾极疾
凡	樊烦帆繁矾	返范犯泛番饭翻反贩
凤	讽奉缝	丰疯峰风封枫锋逢冯蜂
凭	苹萍平评屏坪冯瓶	乒
凯	楷岂慨	咳揩开
凰	黄皇煌惶蝗	恍谎荒慌晃幌
凳	瞪蹬邓	等登灯
凶	兄匈胸汹	雄熊
凸	骨突股古徒滑鼓涂图贾屠谷途	估沽辜秃土吐家雇咕兔顾告姑孤故固
凹		澳袄懊傲拗熬奥
出	初	矗储锄畜触楚橱除处础厨雏
击	辑即籍吃棘脊唧借急嫉级集寂及圾吉极疾	纪叽妓稽给荠记几迹既鲫基饥箕继奇济挤积寄畸冀骑讥际激绩居祭机季剂系计技忌肌其己鸡期
函	韩寒涵汗含	罕旱悍喊和翰撼憾捍焊汉酣
凿	做坐作座	皂蚤糟灶造噪枣遭躁早藻燥澡昨左
刀	叨	道悼到稻盗倒岛导祷蹈捣
刁	雕叼碉	钓掉吊调
刃	赁认韧纫任	仁人儿忍
分	愤芬粪奋份忿吩纷氛	粉焚坟
切	窃怯契	且茄
刊	看堪勘	砍坎
刑	邢行形型	醒腥星性兴姓猩杏幸省
划	豁化画桦话滑猾华哗	花
划	豁桦滑猾华哗	化花话画
列	劣烈猎裂	咧
刘	流榴硫留瘤泵琉	铆陆溜柳六馏
则	窄择泽贼责	怎侧
刚	扛岗纲冈缸肛钢	港
创	疮窗囱闯	抢撞幢床
初	出	矗储锄畜触楚橱除处础厨雏
删	衫山杉珊扇	闪陕善单赡擅膳
判	叛畔盼	胖潘攀般盘
刨	爆袍咆暴炮豹抱报	褒跑堡泡饱包薄雹苞保宝抛胞
利	立吏砾雳丽痢隶沥粒励厉力荔历莉例俐栗	李离礼犁厘理哩黎篱狸梨漓璃里鲤
别		瘪鳖
刮	瓜蜗括	卦挂寡褂
到	道悼稻盗倒导蹈	叨刀岛祷捣
制	智挚致治至秩置窒知滞帜识稚质志	址植直脂掷只氏征织执蜘之枝肢值止纸趾职支吱汁芝殖指旨
刷		耍
券	劝	圈泉卷拳权痊犬全
刹	岔差	察叉插喳查茶
刺	赐伺次厕	瓷此词差雌祠辞慈磁
刻	磕苛科客课蝌棵颗可克	咳坷壳渴
刽	筷会块快
剂	际纪妓荠祭季记系既计鲫继技济忌寄冀骑	叽稽给籍即吃棘脊唧借急几嫉迹基集级箕寂饥及奇挤积畸吉讥激绩辑居机击圾肌其己鸡期极疾
剃	惕屉涕替	剔梯提体啼蹄堤题踢
削	嚣哮宵雪硝箫销萧穴血消	靴晓孝效肖小笑酵校薛学啸
前	干潜黔钱钳	嵌浅千迁欠牵纤签谴铅谦遣歉
剑	践建溅鉴渐健荐监件涧键舰间贱见箭	坚柬拣捡茧兼简尖检剪俭艰碱减煎歼肩奸
剔	梯踢	屉体提涕啼惕剃替蹄堤题
剖	颇	泊泼朴魄坡破波婆迫
剥	玻播拨般菠	泊舶渤搏勃驳白柏伯跛博卜簸薄脖膊荸
剧	聚巨距具拒俱惧炬句锯据足	拘鞠蛆沮居车橘驹矩举局菊
剩	胜盛乘圣	生牲绳升笙省甥声
剪	柬拣捡茧检简俭减碱	践尖建鉴歼健监涧键兼贱肩箭溅渐荐坚艰舰煎间件剑见奸
副	附妇赴傅赋富复咐父腹负付	辐浮缚符麸伏拂脯福斧俘袱甫夫敷芙蝠肤抚俯府辅幅服孵扶腐
割	搁戈胳哥鸽疙歌	阁合格革隔葛蛤各个
剿	侥较搅狡矫抄绞饺角钞超脚缴	轿叫炒窖巢椒嘲胶娇嚼潮吵蕉朝焦教校郊交觉礁骄浇
劈	匹霹批坏被披	屁否脾罢啤疲譬皮僻辟
力	立吏砾雳丽痢隶沥粒励厉荔历莉例俐利栗	李离礼犁厘理哩黎篱狸梨漓璃里鲤
劝	券	圈泉卷拳权痊犬全
办	半扮拌伴绊瓣	班板扳搬颁版般斑
功	宫弓共攻蚣躬工公供恭红	拱汞巩贡矿
加	佳家夹嘉茄	荚钾挟价架稼甲颊夏嫁贾假驾
务	勿晤雾物坞误悟恶	无于伍巫诬午乌吴舞梧武五呜污芜亡屋蜈捂侮鹉
劣	列烈猎裂	咧
动	栋洞冻	懂董东冬
助	住注柱祝铸蛀驻	朱贮煮蛛主猪拄筑术珠属轴竹烛逐诸嘱株
努		奴怒
劫	节杰竭截捷结洁	接揭皆阶届街界介姊借解诫戒姐芥
励	立吏砾雳丽痢隶沥粒厉力荔历莉例俐利栗	李离礼犁厘理哩黎篱狸梨漓璃里鲤
劲	径境竞进靖仅禁竟浸镜晋静尽净敬近	兢荆茎谨襟鲸津经金斤警晶惊锦井京巾今颈精睛阱紧更景筋
劳	烙牢酪唠络	捞姥老
势	拭逝室是使柿侍市士世饰适誓试氏视恃示式识事释嗜	提匙施时屎驶拾狮实诗食什石十史射尸失硕虱蚀矢始师湿
勃	泊舶渤搏白柏伯博卜脖薄驳膊荸	剥跛簸玻播拨般菠
勇	泳蛹踊拥咏永	庸用佣
勉	免冕娩缅	绵眠面棉
勋		逊巡寻讯旬训询驯迅汛循殉
勒	乐肋垃	垒儡泪擂蕾雷累了类
勘	刊堪看	砍坎
募	幕木慕暮沐目牧墓穆睦	亩姥姆母拇模牡
勤	擒秦琴禽芹	侵亲钦寝
勺	蟀硕帅烁数率芍	稍捎少说梢烧绍召哨
勾	沟钩句	苟垢购狗构够
勿	务晤雾物坞误悟恶	无于伍巫诬午乌吴舞梧武五呜污芜亡屋蜈捂侮鹉
匀	云耘	晕酝陨允孕运蕴韵员
包	褒苞胞	爆堡饱刨暴薄雹保豹宝抱报
匆	聪从囱葱	丛
匈	凶胸汹兄	雄熊
匕	彼笔比鄙	逼庇壁毙碧璧臂毕闭鼻弊币必避蔽泌辟
化	划画桦话华	豁花滑猾哗
北		卑臂背贝被辈焙狈惫悲杯备碑倍
匙	驰池迟持弛	拭提翅势室施时屎赤使柿吃侍尺拾嗤饰驶誓狮氏实诗恃什示石食十式史事射耻释嗜适尸失逝硕是虱士蚀市世齿试侈矢视斥识始师湿
匠	将强降酱	桨姜浆江蒋僵疆讲缰奖
匣	狭洽挟暇峡侠霞斜辖	虾厦瞎下吓夏
匪	菲诽	啡非废费沸肺肥吠飞
匹	否霹批被坏劈披	屁脾罢啤疲譬皮僻辟
区	曲圈屈蛆鸥趋躯呕欧岖驱殴	漆去藕取偶娶趣渠
医	揖衣伊一依壹漪	夷疑艺肄意抑仪疫异忆翼益奕液毅屹艾已议以倚谊腋邑逸掖椅乙亦义溢遗移役易姨胰宜尾亿译绎蛇蚁矣
匾	贬扁	辫蝙便辨辩遍变边鞭编
匿	泥腻溺逆	你拟尼呢
十	硕实提食什时石蚀拾射	拭匙势室施屎使柿侍驶饰誓狮氏诗恃示式史事释适嗜尸失逝是虱士市世矢试视识始师湿
千	嵌迁牵纤签谦铅	干浅潜欠黔谴前钱钳遣歉
千	嵌迁牵纤签铅谦	干浅潜欠黔谴前钱钳遣歉
升	生牲胜笙甥声	乘绳剩圣盛省
午	武舞伍捂侮鹉五	无于务雾巫诬乌吴勿梧呜污芜悟亡屋恶蜈晤误物坞
半	拌扮伴绊办瓣	班板扳搬颁版般斑
华	豁化花划画桦话滑猾哗
协	鞋挟携谐斜邪胁	骇屉谢屑写蟹卸契些泻楔歇解懈械血
卑	悲杯背碑	臂贝被辈焙狈惫北备倍
卒	错促趋趣醋族簇足	粗阻诅租祖组
卓	浊茁灼拙着啄琢酌	桌捉
单	馋善蝉扇耽担赡擅丹缠膳	删产弹衫山胆石旦掺淡闪诞陕杉氮搀蛋阐铲珊但
卖	迈脉麦	埋买
南	难男
博	泊舶渤搏勃白柏伯卜脖薄驳膊荸	剥跛簸玻播拨般菠
卜	捕补哺	埠步不怖部布簿
卜	泊舶渤搏勃白柏伯博脖薄驳膊荸	剥跛簸玻播拨般菠
占	栈暂战绽沾站瞻蘸毡颤	崭斩盏展
卡	咳	咖恰哈洽
卢	芦炉庐颅	露录鹿氯卤陆路鲁虏赂碌
卤	虏鲁	露录卢鹿氯炉陆芦颅路庐赂碌
卦	挂褂	刮寡瓜蜗括
卧	沃握	窝涡我
卫	为谓位尉喂伪胃未味遗慰蔚魏畏	委伟尾薇苇违维围威偎萎纬唯危微巍桅
印	饮隐	瘾引吟听银淫因殷蚓茵姻音阴
危	为薇维围违唯微巍桅	委卫位喂胃未味威偎慰谓苇畏伪尉遗萎纬蔚伟尾魏
即	辑籍吃棘脊唧借急嫉击级寂集及圾吉极疾	纪叽妓稽给荠记几迹既鲫基饥箕继奇济挤积寄畸冀骑讥际激绩居祭机季剂系计技忌肌其己鸡期
却	壳鹊怯确雀	瘸缺
卵		乱峦
卷	圈泉拳权痊倦眷犬绢全	券劝鹃捐身
卸	骇屉谢屑蟹契泻楔解懈械	鞋写挟协些携谐歇斜邪血胁
卿	氢倾顷轻清蜻青	亲庆情擎请晴
厂	场敞	唱长昌偿畅常尝肠裳倡猖
厅	听	挺庭蜓廷停艇亭
历	立吏砾雳丽痢隶沥粒励厉力荔莉例俐利栗	李离礼犁厘理哩黎篱狸梨漓璃里鲤
厉	立吏砾雳丽痢隶沥粒励力荔历莉例俐利栗	李离礼犁厘理哩黎篱狸梨漓璃里鲤
压	押鸭鸦呀	牙蚜轧雅讶涯衙亚芽哑
厌	谚咽淹焰艳奄雁验烟沿堰唁砚宴殷研燕	严炎演颜阎延衍癌盐言眼掩
厕	侧刺册伺策赐次测	瓷此词差雌祠辞慈磁
厘	悉膝熙犁畦栖黎吸狸梨携丽晰璃析行离西篱牺漓犀稀溪希嬉蟋	李理习惜隶沥锡徙礼戏励媳历莉隙喜立吏息洗砾雳痢熄席夕系粒袭厉哩力荔昔例俐利里鲤栗细
厚	候后	侯猴吼喉
原	猿源辕援园缘元袁员圆	远宛渊愿怨冤鸳院
厢	相箱乡镶湘香	像橡项想祥向巷详享响翔象降
厦	霎煞暇下吓夏	虾傻沙狭匣杉洽砂挟杀峡侠瞎霞斜辖纱
厨	锄储橱除雏	矗畜初触楚处础出
去	娶趣	曲圈屈蛆趋躯取岖驱区渠
县	现馅陷腺漩线玄悬限旋献宪	喧仙嫌弦炫癣闲掀选纤宣衔险先轩涎舷鲜贤咸显铣
参	呻餐信三绅申深身伸	惭沈甚伞审慎婶惨肾残渗灿蚕散神
又	佑诱有幼右	忧幽尤悠犹游由邮友油优
叉	插喳差	刹察岔查茶
及	辑即籍吃棘脊唧借急嫉击级寂集圾吉极疾	纪叽妓稽给荠记几迹既鲫基饥箕继奇济挤积寄畸冀骑讥际激绩居祭机季剂系计技忌肌其己鸡期
友	有	佑幽由犹悠又油诱优忧尤游邮幼右
双	霜	爽
反	返	樊范犯烦繁帆番饭凡泛翻矾贩
发	伐	阀乏法罚筏
发	法	阀乏伐罚筏
叔	赎熟淑	树梳黍术鼠薯曙述蜀束署书抒暑疏殊枢输属数竖庶蔬恕墅漱舒
取	曲娶	圈屈蛆去漆趋躯岖驱趣区渠
受	售兽瘦授寿	收首守手熟
变	辫辨便辩遍	蝙扁匾边鞭编贬
叙	畜绪恤酗序絮旭婿蓄续	许徐需虚须吁
叛	判畔盼	胖潘攀般盘
叠	碟谍跌蝶	爹
口		寇扣
古	股凸鼓滑贾骨谷	估沽辜家雇咕告顾姑孤故固
句	聚巨剧沟钩具勾距俱拒惧炬锯据足	苟拘鞠蛆沮居车橘垢驹购狗构举矩局够菊
另	令	岭领凌灵菱玲伶蛉铃陵龄翎零
叨	刀	道悼到稻盗倒岛导祷蹈捣
只	址枝肢止纸趾支吱脂汁氏芝知征织指旨蜘之	植致治制直窒掷帜执稚志智挚值职至秩置滞殖识质
只	氏芝枝肢知织蜘支之吱脂汁	址植治致制直窒掷征帜执稚志智挚值止纸趾职至秩置滞殖指识旨质
叫	觉轿窖教校较	椒角胶娇脚嚼矫侥狡绞蕉焦郊搅交饺剿礁骄浇缴
召	昭赵罩招嘲少朝兆着绍照哨	稍找爪捎梢勺烧沼芍
叭	八巴扒捌笆芭疤吧	爸靶霸把伯耙罢拔跋坝
叮	丁盯钉	锭鼎定顶订
可	坷客课刻渴克	咳苛磕科蝌棵壳颗
台	苔抬	胎泰太汰态
史	屎使驶始矢	拭提匙势室施时柿侍拾饰誓狮氏实诗恃什示石食十式事射释嗜适尸失逝硕是虱士蚀市世试视识师湿
右	佑又诱有幼	忧幽尤悠犹游由邮友油优
叶	社页咽赦夜射业舍拾涉摄谒设	甚爷舌什奢野蛇椰也冶赊
号	鹤壕浩镐耗好嚎毫豪	蒿
司	丝思斯撕嘶私	死食四饲伺肆似赐寺
叹	碳探炭	贪檀毯袒谭坦潭弹瘫痰坛昙谈滩摊
叼	雕刁碉	钓掉吊调
叽	激绩稽居唧机几迹基饥箕奇肌其积畸鸡期讥	纪妓即给籍荠吃棘脊借急记嫉既鲫级集寂及继济挤寄冀吉骑际辑祭季剂击系计技忌圾己极疾
吁	域裕玉愈尉育誉浴寓欲芋御狱郁豫预遇语谷喻	逾予雨屿迂于愉渔榆鱼娱舆隅愚羽淤宇
吁	须需虚	许徐绪叙畜恤酗序絮旭婿蓄续
吃	辑即籍棘脊唧嗤借急嫉击级寂集及圾吉极疾	纪翅叽匙妓稽给池赤荠持尺记几迹既鲫基饥箕继奇济挤积寄畸冀耻骑讥际激绩鸡居迟祭机季齿剂侈系计斥驰技忌肌其己弛期
各	个	搁阁格戈隔割葛蛤胳哥鸽疙歌
吆	么夭哟腰要邀妖	侥摇耀药淆舀遥肴谣乐咬钥拗窑姚
合	核盖荷和何河禾盒褐	鹤喝吓呵贺赫
合	阁格革核盖荷和何葛蛤河禾盒褐	搁鹤戈割胳各鸽哥吓疙呵贺赫歌
吉	辑即籍吃棘脊唧借急嫉击级寂集及圾极疾	纪叽妓稽给荠记几迹既鲫基饥箕继奇济挤积寄畸冀骑讥际激绩居祭机季剂系计技忌肌其己鸡期
吊	钓掉调	雕刁叼碉
同	彤桐铜童瞳	统筒桶痛通
名	鸣铭螟明	命
后	候厚	侯猴吼喉
吏	立砾雳丽痢隶沥粒励厉力荔历莉例俐利栗	李离礼犁厘理哩黎篱狸梨漓璃里鲤
吐	土兔	秃凸徒涂图突屠途
向	像橡相项乡巷象	想祥箱镶厢详享响湘翔香降
吓	贺鹤厦和荷暇喝下夏赫	合虾狭匣洽核盖挟何峡河侠瞎禾辖霞斜盒呵褐
吕	侣履屡旅娄缕铝	氯滤律绿虑驴率
吗	码玛马蚂蟆妈	麻骂么
君	均钧龟军	菌窘骏峻竣俊
吝	赁躏	凛临淋鳞琳邻林磷
吞		囤褪臀屯
吟	淫银	印瘾隐引听饮因殷蚓茵音姻阴
吠	废费沸肺	啡肥菲非诽飞匪
否	匹	屁脾霹罢坏疲皮僻劈披辟啤批被譬
吧	八巴扒捌罢笆芭疤叭	爸靶霸把伯耙拔跋坝
吨	囤盹盾顿钝	墩蹲敦
吩	纷氛分芬	粉愤粪奋份忿焚坟
含	韩寒函涵汗	罕旱悍喊和翰撼憾捍焊汉酣
听	厅	挺庭蜓廷停艇亭
听	瘾引隐饮蚓	印吟淫银因殷茵音姻阴
吭	行航杭坑
吮	盾	瞬顺
启	起岂乞稽	泣迄戚漆畦脐妻七只鳍气奇砌契凄企祈骑枝旗栖欺歧柒器棋弃汽齐其溪崎期
吱	资枝肢姿支脂汁只氏芝知滋织蜘之咨	址植自治仔致制直窒掷字征帜执籽稚志智挚值止纸趾职至秩置紫滞殖指识旨子质滓
吴	蜈无芜巫诬亡梧	于务伍雾午乌舞勿武五呜污悟屋恶晤误物坞捂侮鹉
吵	炒	嘲潮抄朝钞超巢剿
吸	悉膝熙厘畦栖携晰析行西牺犀稀嬉希溪蟋	徙习戏息系袭细隙媳喜惜洗昔熄席锡夕
吹	炊	椎垂捶锤
吻	稳	免紊问瘟蚊文闻纹温
吼		猴厚后侯候喉
呀	押鸭压鸦	牙蚜轧雅讶涯衙亚芽哑
呆	待	贷戴袋带大逮代歹怠
呈	惩成城程诚承乘盛橙澄	称秤撑逞
告	估雇顾故固	沽凸糕膏辜高股古家羔篙姑稿谷咕鼓孤滑骨搅搞贾
呐	那钠纳捺娜	拿哪
呕	鸥藕欧偶区殴
员	晕酝猿源原运援园蕴元圆孕辕缘袁韵	陨允远云宛渊怨愿院冤鸳耘匀
呛	抢将枪腔	墙强
呜	于巫诬屋乌恶污	无务伍雾午吴舞勿梧五武芜悟亡蜈晤误物坞捂侮鹉
呢	泥尼	你逆溺匿腻拟
周	州舟粥洲	昼肘咒皱帚轴宙
味	为卫谓位尉喂伪胃未遗慰蔚魏畏	委伟尾薇苇违维围威偎萎纬唯危微巍桅
呵	喝	合鹤贺核盖荷和何河禾吓盒赫褐
呻	信绅申深参身伸	沈甚审慎婶肾渗神
呼	乎忽戏	壶许沪互狐唬户胡护葫虎糊蝴弧湖
命		鸣铭螟明名
咆	刨炮袍	跑泡抛
和	合鹤贺核盖荷何河喝禾吓赫盒酣褐	韩函翰涵汉旱寒活祸含豁悍或汗霍罕喊获伙货火撼憾呵焊捍惑
咏	泳蛹踊拥勇永	庸用佣
咐	附妇赴傅赋富复父腹负副付	辐浮缚符麸伏拂脯福斧俘袱甫夫敷芙蝠肤抚俯府辅幅服孵扶腐
咒	昼宙皱	肘舟周州粥洲轴帚
咕	估辜沽家姑孤	固股凸贾古雇鼓顾告滑故骨谷
咖	哈	咳卡
咙	龙隆胧窿笼聋	拢垄
咧		裂列劣烈猎
咨	资姿滋吱	自字紫仔籽子滓
咪		密靡弥蜜米秘迷谜觅泌糜
咬	夭舀	侥摇么哟淆腰遥肴姚耀药谣乐吆钥拗窑要邀妖
咱	砸杂	暂赞
咳	慨卡壳	骇苛害刻渴咖颗哈克可还开海磕坷凯科客课蝌棵孩岂揩亥楷
咸	嫌衔弦涎舷闲贤	仙现馅显掀险陷先腺纤线限铣癣鲜献县宪
咸	嫌衔弦舷涎闲贤	仙现馅显掀险陷先腺纤线限铣癣鲜献县宪
咽	谚淹焰艳宴雁沿验研燕堰砚厌唁	严炎演颜奄延烟阎殷衍癌盐言眼掩
咽	谚页淹焰艳奄雁烟验沿业堰叶厌谒砚唁宴殷夜研燕射	严炎演爷颜阎野延衍椰癌盐冶言掩眼也
哀	埃挨哎唉	蔼碍爱艾隘矮
品		频贫濒拼聘
哄	轰烘	虹宏汞鸿洪红
哈	咖	蛤咳卡
响	享想	像祥向箱镶巷详湘象降橡相项乡厢翔香
哎	哀挨唉埃	蔼碍爱艾隘矮
哑	噩愕遏饿恶雅亚鳄扼俄	牙阿压蚜芽鸭额鸦轧讶呀讹涯衙押鹅蛾
哗	豁花划桦滑猾华	化话画
哟	么夭腰吆要邀妖	侥摇耀药淆舀遥肴谣乐咬钥拗窑姚
哥	搁戈割胳鸽疙歌	阁合格革隔葛蛤各个
哨	绍少召	稍捎梢勺烧芍
哩	李礼理里鲤	厘黎丽隶沥励历莉篱立吏犁狸梨砾雳痢璃离粒厉力荔漓例俐利栗
哪	那馁	拿钠呐纳捺内娜
哭	窟枯	酷裤库苦
哮	嚣削宵硝箫销萧消	孝晓肖校小笑酵效学啸
哲	摘辙折	遮宅浙这着蔗者
哺	捕补卜	埠步不怖部布簿
哼		横恒衡
唁	谚咽淹焰艳宴雁沿验研燕堰厌砚	严炎演颜奄延烟阎殷衍癌盐言眼掩
唆	缩嗦梭	锁索琐所
唇	醇淳纯	春蠢
唉	哀挨哎埃	蔼碍爱艾隘矮
唐	堂糖棠膛搪塘	淌躺趟烫倘汤
唠	劳牢	烙姥老酪捞络
唤	换幻痪宦焕涣患	缓环欢还
唧	叽即稽籍吃棘脊借急几嫉迹基集级寂饥及箕奇积畸吉讥激绩辑居机击圾肌其鸡期极疾	纪妓给荠记既鲫继济挤寄冀骑际祭季剂系计技忌己
唬	许虎	沪狐互户葫忽胡湖壶呼戏乎护糊蝴弧
售	兽瘦受授寿	收首守手熟
唯	为薇维围违危微巍桅	委卫位喂胃未味威偎慰谓苇畏伪尉遗萎纬蔚伟尾魏
唱	倡畅	场长昌偿厂常尝肠裳敞猖
唾	拓	拖椭托脱驮驼鸵妥
啃	垦肯恳
啄	卓浊茁灼拙着琢酌	桌捉
商	伤汤	上尚裳赏晌
啊	阿
啡	菲非飞	废费沸肺诽吠肥匪
啤	皮脾疲罢	屁否匹霹批坏被譬僻劈披辟
啦	拉喇	辣落蜡腊
啸	孝肖校笑酵效	嚣晓哮削宵小硝箫销萧学消
啼	题提蹄堤	剔屉体涕梯惕剃替踢
喂	为卫谓位尉伪胃未味遗慰蔚魏畏	委伟尾薇苇违维围威偎萎纬唯危微巍桅
善	单扇赡擅膳	闪衫山陕杉删珊
喇	拉啦	辣落蜡腊
喉	侯猴	候吼厚后
喊	罕	韩悍和函翰涵汗汉酣旱寒撼憾捍焊含
喘		穿川传船串
喜	洗徙	悉熙厘习畦惜锡戏媳隙牺西希膝息栖吸携晰熄析席夕行系袭昔犀稀溪嬉蟋细
喝	鹤荷和吓呵贺赫	合核盖何河禾盒褐
喧	宣轩	选炫漩玄悬旋还县
喳	叉差查渣插扎	眨刹栅诈察岔炸乍茶闸
喷		盆
喻	域裕玉愈尉育誉浴寓欲芋御狱郁与豫预遇语吁谷	逾予雨屿迂于愉渔榆鱼娱舆隅愚羽淤宇
嗅	锈臭宿袖秀绣	朽休修羞
嗓		丧桑
嗜	拭势逝室是使柿侍市士世饰试誓氏视恃示式识事释适	提匙施时屎驶拾狮实诗食什石十史射尸失硕虱蚀矢始师湿
嗡	翁
嗤	吃	翅匙弛驰斥池迟赤持尺齿耻侈
嗦	缩梭唆	锁索琐所
嗽		搜
嘀	笛的嫡涤敌芽	弟抵蒂低递帝滴底第地缔
嘉	佳加家夹茄	荚钾挟价架稼甲颊夏嫁贾假驾
嘱	贮煮主属拄	助朱住注蛛猪柱筑术珠祝铸轴竹烛蛀诸逐驻株
嘲	昭招潮朝巢着召	赵罩找爪抄吵钞超兆炒剿沼照
嘴		堆罪最醉
嘶	司丝思斯撕私	死食四饲伺肆似赐寺
嘹	聊撩疗缭辽寥潦燎僚	了料
嘿	黑
器	泣迄气弃砌汽契企妻	戚稽畦漆脐七只鳍奇凄祈骑枝旗启栖欺起歧柒乞棋齐其溪崎岂期
噩	愕俄遏饿恶鳄扼哑	阿额讹鹅蛾
噪	皂躁造灶燥	蚤糟早枣遭藻凿澡
嚎	鹤壕号毫豪	浩镐耗好蒿
嚣	哮削宵硝箫销萧消	孝晓肖校小笑酵效学啸
嚷	攘壤	让瓤
嚼	掘倔决觉角绝诀爵脚	轿叫窖椒胶娇较矫侥狡绞蕉焦教校郊搅交饺剿礁骄浇缴
囚	求仇球	蚯丘龟秋
四	食饲肆伺似赐寺	死司丝思斯撕嘶私
回	茴蛔	恢虫堕挥诲灰秽惠讳贿汇绘辉毁徽悔晦慧溃会
因	殷应茵音姻阴	印瘾隐吟听银淫饮引蚓
囤	臀吨盹盾屯顿钝	吞敦墩蹲褪
园	猿源辕原援缘元袁员圆	远宛渊愿怨冤鸳院
困		捆坤昆
囱	聪从窗疮创匆葱	丛抢幢闯床撞
围	为薇维违唯危微巍桅	委卫位喂胃未味威偎慰谓苇畏伪尉遗萎纬蔚伟尾魏
固	估雇告顾故	孤沽辜股凸古家咕鼓姑滑贾骨谷
国		锅过裹果郭
图	凸徒涂突屠途	土吐兔秃
圃	普浦谱	菩瀑仆扑葡朴铺暴蒲脯
圆	猿源辕原援缘园元袁员	远宛渊愿怨冤鸳院
圈	曲卷屈蛆鹃趋躯身倦眷捐岖驱区绢	泉券拳全漆去权劝犬取娶趣痊渠
土	吐	秃凸徒兔涂图突屠途
圣	胜盛剩乘	生牲绳升笙省甥声
在	载再	仔灾宰栽
地	的弟蒂递帝第缔	笛抵嘀低嫡滴底涤敌芽
场	长偿厂常尝肠裳敞	唱昌畅倡猖
圾	辑即籍吃棘瑟脊色借唧塞急嫉涩击级寂集及吉极疾	纪叽妓稽给荠记几迹既鲫基饥箕继奇济挤积寄畸冀骑讥际激绩居祭机季剂系计技忌肌其己鸡期
址	只征止指纸趾旨	植治致制直脂窒掷氏织帜执稚蜘之志智挚枝肢值职至支秩吱置汁芝知滞殖识质
均	君钧龟军	菌窘骏峻竣俊
坊	芳房妨肪方防	放访纺仿
坎	砍	刊勘堪看
坏		怀淮徊槐
坏	匹霹批被胚劈披	陪培徊否屁佩脾赔罢啤淮配沛怀疲槐譬皮僻辟
坐	凿座做	昨左
坑	吭
块	筷会快刽
坚	兼尖艰溅歼煎渐间监肩奸	践建鉴健涧拣捡键检碱贱箭柬简剪荐茧俭舰减见件剑
坛	弹檀痰昙谈谭潭	贪瘫毯碳叹炭探滩袒坦摊
坝	爸霸伯罢耙	八靶巴跋扒捌把笆芭拔疤吧叭
坞	勿务晤雾物误悟恶	无于伍巫诬午乌吴舞梧武五呜污芜亡屋蜈捂侮鹉
坟	焚	粉愤芬粪奋分份忿吩纷氛
坠	缀赘	锥椎追
坡	波泼	泊剖朴魄颇破婆迫
坤	昆	捆困
坦	袒毯	贪檀碳炭叹探谭潭弹瘫痰坛昙谈滩摊
坪	苹萍评屏平冯瓶凭	乒
坷	可渴	咳磕苛科客课蝌棵刻壳颗克
垂	捶椎锤	吹炊
垃	勒乐肋	了
垄	拢	咙龙隆胧窿笼聋
型	邢刑形行	醒腥星性兴姓猩杏幸省
垒	蕾累儡	勒泪擂雷类
垢	够购构	苟勾沟钩狗句
垦	肯恳啃
垫	店殿甸玷淀佃奠电惦	颠典点碘
垮		夸跨胯
埂	耿梗	羹更耕
埃	哀挨哎唉	蔼碍爱艾隘矮
埋		迈麦脉卖买
城	呈成惩程诚承乘盛橙澄	称秤撑逞
域	裕玉愈尉育誉浴寓欲芋御狱郁与豫预遇语吁谷喻	逾予雨屿迂于愉渔榆鱼娱舆隅愚羽淤宇
埠	步簿怖部布不	捕补哺卜
培	陪赔	佩坏配胚沛
基	激绩叽稽居唧机几迹饥箕奇肌其积畸鸡期讥	纪妓即给籍荠吃棘脊借急记嫉既鲫级集寂及继济挤寄冀吉骑际辑祭季剂击系计技忌圾己极疾
堂	唐糖棠膛搪塘	淌躺趟烫倘汤
堆		兑嘴队对醉罪最
堕	恢踱舵惰跺驮挥辉度徽灰	虫诲秽朵夺茴惠多慧溃会躲讳贿汇回绘毁悔晦蛔
堡	宝饱保	爆包刨暴薄雹苞豹褒抱报胞
堤	题提蹄啼	剔屉体涕梯惕剃替踢
堪	刊看勘	砍坎
堰	谚咽淹焰艳宴雁沿验研燕砚厌唁	严炎演颜奄延烟阎殷衍癌盐言眼掩
堵	睹赌肚	牍渡督毒杜都读镀度妒独
塑	缩肃宿粟诉素速溯	酥苏俗
塔		蹋踏塌
塘	堂唐糖棠膛搪	淌躺趟烫倘汤
塞	瑟圾色腮赛涩
填	恬甜田	添天舔
境	径竞静净劲敬靖竟镜	颈兢惊鲸经精睛阱荆茎井警京更景晶
墅	树疏术数述竖庶束署曙恕漱	暑梳殊枢黍输鼠薯叔属蜀淑书蔬舒赎熟抒
墓	幕募木慕暮沐目牧穆睦	亩姥姆母拇模牡
墙	强	将抢呛枪腔
增	憎曾	赠
墨	默漠磨脉末沫莫膜陌寞茉没	么蘑摩魔抹摸摹模
墩	蹲敦	囤吨盹盾顿钝
壁	庇毙臂毕弊币必避辟泌碧璧闭比蔽鄙	逼彼鼻匕笔
壕	鹤号毫嚎豪	浩镐耗好蒿
壤	攘嚷	让瓤
士	拭势逝室是使柿侍市世饰适誓试氏视恃示式识事释嗜	提匙施时屎驶拾狮实诗食什石十史射尸失硕虱蚀矢始师湿
壮	撞状	妆装庄桩
声	生牲升胜笙甥	乘绳剩圣盛省
壳	窍咳峭跷撬翘俏怯鹊确雀却	巧桥苛瞧刻渴颗克敲悄坷蝌棵瘸侨憔乔可缺磕锹客科课
壶	狐胡葫糊蝴弧湖	许呼沪互戏唬户乎护虎忽
壹	揖衣医伊一依漪	夷疑艺肄意抑仪疫异忆翼益奕液毅屹艾已议以倚谊腋邑逸掖椅乙亦义溢遗移役易姨胰宜尾亿译绎蛇蚁矣
处	矗储畜触楚础	锄初橱除厨雏出
备	臂背贝被辈焙狈惫倍	卑悲杯北碑
复	附妇赴傅赋富咐父腹负副付	辐浮缚符麸伏拂脯福斧俘袱甫夫敷芙蝠肤抚俯府辅幅服孵扶腐
夏	厦钾暇甲下吓贾假	洽价瞎霞嘉荚家稼嫁辖架佳狭匣加挟斜夹驾虾峡侠颊茄
夕	戏细隙系	悉膝熙厘习畦息栖吸惜洗携晰熄析锡席行徙袭媳西喜牺昔犀稀嬉希溪蟋
多	朵夺	踱堕躲舵惰跺驮度
夜	页咽业叶射谒	爷野椰也冶
够	购构垢	苟勾沟钩狗句
大	贷戴袋带代待逮怠	答搭达呆歹瘩打
天	添	舔恬填甜田
太	态汰泰	台抬胎苔
夫	敷芙辐蝠缚肤符麸伏拂福幅服俘孵袱扶	妇赴腹付脯附赋斧父负甫傅咐抚俯府辅富复腐副
夭	么哟舀腰咬吆要邀妖	侥摇耀药淆遥肴谣乐钥拗窑姚
央	鸯秧殃	阳羊养杨扬痒样氧仰洋漾
失	狮施诗虱师湿尸	拭提匙势室时屎使柿侍驶拾饰誓氏实食恃什示石十式史事射释适嗜硕逝是市士蚀世矢试视识始
头	投	偷透
夷	宜疑蛇遗仪一移姨胰谊	医艺肄意抑伊疫异漪忆翼衣益奕液毅屹艾依已议以倚腋邑逸掖椅乙亦义溢役易揖尾亿译绎蚁矣壹
夸		垮跨胯
夹	佳荚加挟家颊嘉茄	假钾贾价稼甲嫁夏架驾
夺	多	朵踱堕躲舵惰跺驮度
奄	淹咽殷烟燕厌	炎艳焰延雁癌砚衍盐言掩谚颜验沿堰眼唁演阎宴研严
奇	激绩叽枝旗畦稽居鸡唧机脐歧几迹只鳍基饥箕棋肌积齐其畸崎祈骑期讥	纪泣迄妓戚漆籍给荠即吃棘脊借记急妻嫉七既鲫级寂气集及继砌济契挤寄凄企冀吉际启辑栖祭欺季柒剂起击系计器乞弃技圾汽忌溪己岂极疾
奈	奶耐乃
奉	讽凤缝	丰疯峰风封枫锋逢冯蜂
奋	愤粪分份忿	粉芬吩焚纷氛坟
奏	揍骤	走
契	骇屉泣迄屑蟹怯楔窃懈械妻谢器切气弃砌卸汽企泻解	鞋戚畦稽漆谐歇脐邪七只鳍写协奇凄些祈且骑枝启旗栖挟携欺斜起歧柒胁乞棋齐其溪崎岂血期茄
奔		本笨
奕	腋邑逸艺肄掖亦意抑义溢疫异役易忆翼衣益亿液毅译绎屹艾一议谊	夷疑医仪伊漪依已以倚椅乙遗移姨胰宜尾揖蛇蚁矣壹
奖	蒋讲桨	将姜浆酱江僵强匠疆缰降
套		掏滔萄逃淘陶讨桃涛
奠	店垫殿甸玷淀佃电惦	颠典点碘
奢	赊	社甚舌赦什射舍蛇叶拾涉摄设
奥	澳傲懊拗	袄熬凹
女	乳辱	蠕入如褥儒
奴		努怒
奶	奈乃	耐
奸	坚兼尖艰溅歼煎渐间监肩	践建鉴健涧拣捡键检碱贱箭柬简剪荐茧俭舰减见件剑
好	浩镐号耗	鹤壕毫嚎蒿豪
如	儒蠕	女入辱褥乳
妄	王旺忘望	往网枉亡汪
妆	装庄桩	壮撞状
妇	附赴傅赋富复咐父腹负副付	辐浮缚符麸伏拂脯福斧俘袱甫夫敷芙蝠肤抚俯府辅幅服孵扶腐
妈	吗	码玛么马蚂蟆麻骂
妒	肚渡杜度镀	牍堵督毒都读睹独赌
妓	际纪荠祭季记剂系既计鲫继技济忌寄冀骑	叽稽给籍即吃棘脊唧借急几嫉迹基集级箕寂饥及奇挤积畸吉讥激绩辑居机击圾肌其己鸡期极疾
妖	么夭哟腰吆要邀	侥摇耀药淆舀遥肴谣乐咬钥拗窑姚
妙	庙	描秒瞄苗渺藐
妥	椭	拖托唾脱拓驮驼鸵
妨	肪坊房防	芳放访纺方仿
妹	昧媚	美媒煤每霉枚梅楣玫眉没
妻	泣迄戚漆栖欺柒七器气弃砌汽契凄企溪	只鳍枝启旗稽畦乞棋奇歧齐其崎脐祈起岂骑期
姆	亩姥母拇牡	幕募木慕暮沐目牧墓穆模睦
姊	姐解	节杰竭截街劫借结洁戒芥接揭阶届界介捷皆诫
始	屎使史驶矢	拭提匙势室施时柿侍拾饰誓狮氏实诗恃什示石食十式事射释嗜适尸失逝硕是虱士蚀市世试视识师湿
姐	姊解	节杰竭截街劫借结洁戒芥接揭阶届界介捷皆诫
姑	估辜沽家咕孤	固股凸贾古雇鼓顾告滑故骨谷
姓	兴性杏幸	邢行型刑形醒腥星猩省
委	伟尾苇威偎萎纬	为卫位喂维未胃味慰谓围巍畏薇伪尉违遗蔚微桅唯危魏
姚	侥摇淆遥肴谣窑	么耀夭哟舀腰药乐咬吆要拗钥邀妖
姜	将浆江僵疆缰	桨酱蒋强匠讲奖降
姥	亩老姆母拇牡	劳模烙牢幕募慕木酪暮捞沐唠牧目墓穆络睦
姨	夷宜疑蛇遗仪一移胰谊	医艺肄意抑伊疫异漪忆翼衣益奕液毅屹艾依已议以倚腋邑逸掖椅乙亦义溢役易揖尾亿译绎蚁矣壹
姻	因殷茵音阴	印瘾隐吟听银淫饮引蚓
姿	资滋咨吱	自字紫仔籽子滓
威	委偎萎	为卫薇位喂伪尉维胃未味违遗纬慰蔚微桅伟尾谓苇围唯危魏巍畏
娃		袜瓦洼蛙挖
娄	侣履屡旅楼缕铝吕	露漏陋氯滤律绿虑搂驴率篓
娇	交椒蕉胶焦礁教骄浇郊	矫侥搅狡轿叫觉绞饺角窖剿校脚较嚼缴
娘		酿
娜	那钠呐纳挪捺	拿懦哪糯诺
娩	免冕碗宛婉晚勉缅挽	玩顽棉万腕眠丸绵完豌惋湾弯面
娱	逾予愉于渔榆鱼舆隅愚	屿愈浴淤狱与豫遇羽语谷喻域裕雨玉尉育誉寓欲御迂郁预吁芋宇
娶	曲去漆取趣	圈屈蛆趋躯岖驱区渠
婆		泊剖泼朴魄颇破坡波迫
婉	宛娩碗晚挽	玩顽万腕丸豌完惋湾弯
婚	昏荤	浑魂混
婴	莺鹦英应缨樱鹰	荧影营迎莹蝇映赢萤景颖硬盈
婶	审沈	甚呻神慎信肾申绅渗深参身伸
婿	叙畜绪恤酗序絮旭蓄续	许徐需虚须吁
媒	煤霉枚梅楣玫眉没	美每昧媚妹
媚	昧妹	美媒煤每霉枚梅楣玫眉没
媳	习袭息昔惜熄席锡	悉熙厘畦徙戏隙西喜牺希膝栖吸洗携晰析系行夕犀稀溪嬉蟋细
嫁	假价稼贾架驾	佳荚钾挟加家甲颊夏夹嘉茄
嫂	扫	骚艘搔
嫉	辑即籍吃棘脊唧借急击级寂集及圾吉极疾	纪叽妓稽给荠记几迹既鲫基饥箕继奇济挤积寄畸冀骑讥际激绩居祭机季剂系计技忌肌其己鸡期
嫌	衔弦涎舷闲贤咸	仙现馅显掀险陷先腺纤线限铣癣鲜献县宪
嫡	笛的嘀涤敌芽	弟抵蒂低递帝滴底第地缔
嬉	悉膝熙厘畦栖吸携晰析行西牺犀稀溪希蟋	徙习戏息系袭细隙媳喜惜洗昔熄席锡夕
子	仔滓籽紫	资滋自字姿吱咨
孔	恐	控空
孕	晕酝运蕴韵员	陨允云耘匀
字	自	资滋紫仔姿籽子吱滓咨
存		村寸
孙		笋损
孝	效肖笑酵校啸	嚣晓哮削宵小硝箫销萧学消
孟	梦	锰蒙萌猛檬朦盟
季	际纪妓荠祭记剂系既计鲫继技济忌寄冀骑	叽稽给籍即吃棘脊唧借急几嫉迹基集级箕寂饥及奇挤积畸吉讥激绩辑居机击圾肌其己鸡期极疾
孤	估沽辜家咕姑	固股凸贾古雇鼓顾告滑故骨谷
学	穴	靴哮肖削宵雪笑硝校萧消啸孝嚣晓小箫销酵效薛血
孩	还	骇咳害亥海
孵	肤麸敷夫	妇赴辐浮缚腹符伏拂付脯附赋斧福父俘负袱甫芙傅蝠咐抚俯府辅富复幅服扶腐副
孽	聂镊	捏
宁	拧凝狞柠	泞
宅	浙这蔗	窄斋遮债摘辙哲齐祭着责寨者折
宇	予屿雨与语羽	于愈愉榆浴淤狱渔娱豫舆隅遇谷喻域逾裕玉尉育誉鱼寓欲愚御迂郁预吁芋
守	首手	售收熟兽瘦受授寿
安	鞍庵氨	按案暗岸俺
宋	诵颂送讼	耸松
完	玩丸顽	万腕碗娩宛豌惋湾婉晚弯挽
宏	洪鸿红虹	汞轰哄烘
宗	踪棕纵综	从总
官	观关棺冠	馆管惯贯罐灌
宙	咒昼皱	肘舟周州粥洲轴帚
定	锭订钉	丁盯叮鼎顶
宛	碗娩渊冤鸳婉晚挽	原完园元顽远腕怨袁湾猿源万愿豌援惋弯院圆玩辕丸缘员
宜	夷疑蛇遗仪一移姨胰谊	医艺肄意抑伊疫异漪忆翼衣益奕液毅屹艾依已议以倚腋邑逸掖椅乙亦义溢役易揖尾亿译绎蚁矣壹
宝	堡饱保	爆包刨暴薄雹苞豹褒抱报胞
实	硕提食什时石十蚀拾射	拭匙势室施屎使柿侍驶饰誓狮氏诗恃示式史事释适嗜尸失逝是虱士市世矢试视识始师湿
宠		虫充重崇冲
审	婶沈	甚呻神慎信肾申绅渗深参身伸
客	克课刻可	磕苛咳坷科蝌棵壳渴颗
宣	喧轩	选炫漩玄悬旋还县
室	拭势逝是使柿侍市士世饰适誓试氏视恃示式识事释嗜	提匙施时屎驶拾狮实诗食什石十史射尸失硕虱蚀矢始师湿
宦	唤换幻痪焕涣患	缓环欢还
宪	现馅陷腺线限献县	仙嫌显衔闲弦险掀先纤涎舷癣鲜铣贤咸
宫	弓共攻蚣躬工公供恭功红	拱汞巩贡矿
宰	仔载	灾栽在再
害	骇亥	孩咳还海
宴	谚咽淹焰艳雁沿验研燕堰砚厌唁	严炎演颜奄延烟阎殷衍癌盐言眼掩
宵	嚣哮削硝箫销萧消	孝晓肖校小笑酵效学啸
家	佳加夹嘉茄	荚钾挟价架稼甲颊夏嫁贾假驾
家	沽辜估佳加咕姑孤夹嘉茄	凸钾价甲顾荚股古稼雇嫁架假谷挟鼓告滑夏骨驾贾颊故固
容	溶荣绒蓉榕熔融茸	冗
宽		款
宾	缤滨彬濒	鬓
宿	锈缩臭速肃袖粟塑诉嗅素秀朽溯绣	羞酥休俗苏修
寂	辑即籍吃棘脊唧借急嫉击级集及圾吉极疾	纪叽妓稽给荠记几迹既鲫基饥箕继奇济挤积寄畸冀骑讥际激绩居祭机季剂系计技忌肌其己鸡期
寄	际纪妓荠祭季记剂系既计鲫继技济忌冀骑	叽稽给籍即吃棘脊唧借急几嫉迹基集级箕寂饥及奇挤积畸吉讥激绩辑居机击圾肌其己鸡期极疾
密	蜜秘觅泌	咪靡弥米迷谜糜
寇	扣	口
富	附妇赴傅赋复咐父腹负副付	辐浮缚符麸伏拂脯福斧俘袱甫夫敷芙蝠肤抚俯府辅幅服孵扶腐
寒	韩函涵汗含	罕旱悍喊和翰撼憾捍焊汉酣
寓	域裕玉愈尉育誉浴欲芋御狱郁与豫预遇语吁谷喻	逾予雨屿迂于愉渔榆鱼娱舆隅愚羽淤宇
寝		勤亲擒秦钦琴禽侵芹
寞	默漠磨墨脉末沫莫膜陌茉没	么蘑摩魔抹摸摹模
察	茶查	刹岔叉喳差插
寡		瓜挂褂卦蜗括刮
寥	聊撩疗缭辽潦燎僚嘹	了料
寨	债祭责	窄斋宅摘齐
寸		村存
对	兑队	堆
寺	食四饲伺肆似赐	死司丝思斯撕嘶私
寻	巡旬询驯循	逊衅欣讯薪殉训新辛信勋心锌迅汛芯
导	道悼到稻盗倒岛祷蹈捣	刀叨
寿	售兽瘦授受	收首守手熟
封	丰疯峰风枫锋讽蜂	奉凤缝逢冯
射	页咽提硕时业舍蚀叶拾涉摄谒设社实食什石十夜赦	拭匙势室施屎使柿侍驶饰冶誓狮氏舌诗恃示奢野式史事释嗜适尸失逝是虱士市世赊矢试视甚爷识蛇椰也始师湿
将	浆姜江酱抢僵强匠疆呛枪缰降腔	桨蒋墙讲奖
尉	为卫位喂愈未胃味浴慰谓狱与豫遇语谷喻域裕畏玉伪育誉遗寓欲蔚御郁预魏吁芋	委屿于愉维榆威偎淤苇娱渔围舆隅羽巍逾雨予薇违鱼萎纬愚微桅迂尾伟唯危宇
尊	遵	俊
小	晓	哮肖削宵笑硝校萧消啸嚣孝箫销酵效学
少	绍召哨	稍捎梢勺烧芍
尔	耳饵	二贰而儿
尖	坚兼艰溅歼煎渐间监肩奸	践建鉴健涧拣捡键检碱贱箭柬简剪荐茧俭舰减见件剑
尘	沈臣晨沉陈辰忱	趁称衬
尚	上	商裳汤赏伤晌
尝	场长偿常肠裳	唱昌厂畅倡敞猖
尤	由犹游邮油	佑忧幽悠友又诱有幼优右
就	舅臼旧救疚究	九酒久揪鸠韭灸纠玖
尸	狮失诗施虱师湿	拭提匙势室时屎使柿侍驶拾饰誓氏实食恃什示石十式史事射释适嗜硕逝是市士蚀世矢试视识始
尺	齿耻侈	翅匙斥驰迟池赤持吃嗤弛
尼	泥呢	你逆溺匿腻拟
尽	进劲仅禁浸近晋	津金斤锦紧巾今谨筋襟
尽	进紧锦劲仅谨禁浸近晋	津金斤巾今筋襟
尾	委伟椅乙苇矣蚁纬萎已以倚	喂艺医未味威仪疫忆谓翼奕液毅一议巍谊畏腋薇逸掖义移役蔚易姨微宜亿绎译蛇危夷为卫疑位肄维胃意抑偎伊慰异漪衣益围屹艾依邑尉伪亦违遗溢胰桅揖唯壹魏
尿		鸟
局	鞠橘菊	聚蛆沮居车具俱炬举锯句据拘巨剧距拒驹惧矩足
屁	辟僻譬	否匹脾霹啤批坏被罢疲皮劈披
层	曾
居	激绩叽蛆稽沮车俱唧机锯几迹拘基饥箕奇驹积肌其畸鸡期讥	纪妓聚即给籍荠具棘吃脊炬举急借局记嫉既鲫级集寂巨及继济橘挤寄矩冀吉骑足际辑祭句季剂据菊击系计鞠剧距技忌拒圾惧己极疾
屈	曲圈蛆趋躯岖驱区	漆去取娶趣渠
屉	骇惕涕屑谢剃蟹卸替契泻楔解懈械	体提鞋谐歇邪剔啼写协些蹄堤题挟携斜胁梯血踢
届	介界解借诫戒芥	接节杰竭截揭阶皆街劫捷姊结洁姐
屋	于巫诬乌呜污恶	无务伍雾午吴舞勿梧五武芜悟亡蜈晤误物坞捂侮鹉
屎	使史驶始矢	拭提匙势室施时柿侍拾饰誓狮氏实诗恃什示石食十式事射释嗜适尸失逝硕是虱士蚀市世试视识师湿
屏	苹萍饼平禀柄评秉坪丙冯瓶凭	冰兵乒病并
屑	骇屉谢蟹卸契泻楔解懈械	鞋写挟协些携谐歇斜邪血胁
展	崭斩盏	栈暂毡战占沾站瞻蘸绽颤
属	暑贮嘱主煮黍鼠薯数蜀署拄	朱住猪筑术珠曙轴束书助蛛柱铸庶恕漱舒熟逐树梳叔述诸赎株抒疏注殊枢祝输淑竖竹烛蛀蔬墅驻
屠	凸徒涂图突途	土吐兔秃
屡	侣履旅娄缕铝吕	氯滤律绿虑驴率
履	侣屡旅娄缕铝吕	氯滤律绿虑驴率
屯	囤谆臀	吞褪准
山	衫杉删珊扇	闪陕善单赡擅膳
屹	腋邑逸艺肄掖亦意抑义溢疫异役易忆翼衣益亿奕液毅译绎艾一议谊	夷疑医仪伊漪依已以倚椅乙遗移姨胰宜尾揖蛇蚁矣壹
屿	予雨与语羽宇	于愈愉榆浴淤狱渔娱豫舆隅遇谷喻域逾裕玉尉育誉鱼寓欲愚御迂郁预吁芋
岁	祟穗碎隧遂	随髓虽
岂	启凯稽乞慨楷起	泣迄戚漆畦脐妻开七只鳍气奇砌契凄企祈骑枝旗栖期欺歧柒咳器棋弃汽齐其溪崎揩
岔	刹差	察叉插喳查茶
岖	曲圈屈蛆趋躯驱区	漆去取娶趣渠
岗	扛港纲冈缸肛钢刚
岛	导倒祷捣	道叨悼到稻盗刀蹈
岭	领	凌灵另菱令玲伶蛉铃陵龄翎零
岳	悦越阅耀药粤跃说乐钥月	约
岸	案按暗	鞍庵氨俺安
峡	狭匣洽挟暇侠霞斜辖	虾厦瞎下吓夏
峦		卵乱
峭	窍跷撬壳翘俏	巧桥侨锹瞧憔乔鹊敲悄雀
峰	丰疯风封枫锋讽蜂	奉凤缝逢冯
峻	骏俊竣菌	窘君钧均龟军
崇	虫重	宠充冲
崎	只鳍枝旗棋畦奇齐其脐祈歧骑期	泣迄戚稽漆妻七气砌契凄企启栖欺柒起器乞弃汽溪岂
崔	催衰摧	悴翠脆粹
崩	绷	蹦
崭	斩盏展	栈暂毡战占沾站瞻蘸绽颤
嵌	千迁牵纤签谦铅	干浅潜欠黔谴前钱钳遣歉
巍	为薇维围违唯危微桅	委卫位喂胃未味威偎慰谓苇畏伪尉遗萎纬蔚伟尾魏
川	穿	传喘船串
州	周舟粥洲	昼肘咒皱帚轴宙
巡	寻旬询驯循	逊讯训勋迅汛殉
巢	朝嘲潮	吵抄钞超炒剿
工	宫弓共攻蚣躬公供恭功红	拱汞巩贡矿
左		凿作做坐昨座
巧	悄鹊雀	窍桥侨峭锹跷瞧撬憔壳乔翘俏敲
巨	聚剧距具拒俱惧炬句锯据足	拘鞠蛆沮居车橘驹矩举局菊
巩	共拱矿汞	宫红弓攻蚣躬工公贡恭功供
巫	蜈吴于无芜亡诬梧乌屋呜污恶	武舞务伍勿雾晤误物坞悟捂侮午鹉五
差	刹雌岔叉喳插拆	瓷厕察柴次刺词此赐伺查茶祠辞豺慈磁
己	给济挤脊几	纪妓叽即稽籍荠吃棘唧借记急嫉迹既鲫基集级寂及饥箕继奇积寄畸冀吉骑讥际激绩辑居祭机季剂击系计技忌圾肌其鸡期极疾
已	尾椅乙蚁矣以倚	夷疑医艺肄意抑仪伊疫异漪忆翼衣益奕液毅屹艾一依议谊腋邑逸掖亦义溢遗移役易姨胰宜揖亿译绎蛇壹
巴	八扒捌笆芭疤吧叭	爸靶霸把伯耙罢拔跋坝
巷	像相橡项向乡象	想祥箱镶厢详享响湘翔香降
巾	津金斤禁浸今筋襟	进尽锦紧劲仅谨近晋
币	庇毙臂毕弊必避辟泌壁碧璧闭比蔽鄙	逼彼鼻匕笔
市	拭势逝室是使柿侍士世饰适誓试氏视恃示式识事释嗜	提匙施时屎驶拾狮实诗食什石十史射尸失硕虱蚀矢始师湿
布	埠步簿怖部不	捕补哺卜
帅	蟀硕烁数率勺	说摔甩衰
帆	樊繁烦番凡翻矾	返范犯泛饭反贩
师	狮失施诗虱湿尸	拭提匙势室时屎使柿侍驶拾饰誓氏实食恃什示石十式史事射释适嗜硕逝是市士蚀世矢试视识始
希	悉膝熙厘畦栖吸携晰析行西牺犀稀嬉溪蟋	徙习戏息系袭细隙媳喜惜洗昔熄席锡夕
帐	丈涨长胀杖仗账障	彰掌樟张章
帕	怕	爬趴耙扒
帖	贴铁
帘	怜连镰莲联廉	恋练脸敛炼链
帚	肘	昼舟周咒州粥皱洲轴宙
帜	智挚知致治滞质识稚至制秩置志窒	址植直脂掷只氏征织执蜘之枝肢值止纸趾职支吱汁芝殖指旨
帝	的弟蒂递第地缔	笛抵嘀低嫡滴底涤敌芽
带	贷戴袋大待逮代怠	歹呆
席	习袭息媳昔惜熄锡	悉熙厘畦徙戏隙西喜牺希膝栖吸洗携晰析系行夕犀稀溪嬉蟋细
帮	傍梆邦	蚌谤旁膀榜磅棒绑
常	场长偿尝肠裳	唱昌厂畅倡敞猖
帽	贸冒貌茂	毛茅矛锚猫
幅	芙辐蝠浮福服缚俘袱符扶伏拂夫	妇赴腹麸付脯附赋斧父负甫敷傅咐肤抚俯府辅富复孵腐副
幌	恍谎晃	黄荒皇慌煌凰惶蝗
幔	漫蔓曼慢	瞒蛮满馒
幕	募木慕暮沐目牧墓穆睦	亩姥姆母拇模牡
幢	撞床	抢窗囱闯疮创
干		感赶敢肝竿秆杆甘柑橄
干	潜肝黔前钱竿钳杆甘柑	浅感嵌千赶迁欠敢牵纤签谴秆铅谦遣歉橄
干	肝竿杆甘柑	感赶敢秆橄
平	苹萍评屏坪冯瓶凭	乒
年		撵碾念捻
并	病	饼柄禀冰兵秉屏丙
幸	性辛兴姓杏	邢行型刑形醒腥星猩省
幻	唤换痪宦焕涣患	缓环欢还
幼	佑又诱有右	忧幽尤悠犹游由邮友油优
幽	悠优忧	佑尤由游友邮犹又油诱有幼右
广		逛光
庄	妆装桩	壮撞状
庆	亲	氢清倾卿情擎轻顷请蜻晴青
庇	毙臂毕弊币必避辟泌壁碧璧闭比蔽鄙	逼彼鼻匕笔
床	撞幢	抢窗囱闯疮创
序	叙畜绪恤酗絮旭婿蓄续	许徐需虚须吁
庐	芦炉卢颅	露录鹿氯卤陆路鲁虏赂碌
库	裤酷	窟枯苦哭
应	莺鹦婴英映缨樱硬鹰	荧影营迎景蝇赢萤莹颖盈
底	抵	嘀蒂嫡帝芽缔笛的弟低递滴第涤敌地
店	垫殿甸玷淀佃奠电惦	颠典点碘
庙	妙	描秒瞄苗渺藐
府	斧父抚俯甫腐辅脯	妇赴辐浮缚腹符麸伏拂付附赋福俘负袱夫芙敷傅蝠咐肤富复幅服孵扶副
庞	膀螃旁	胖乓磅
废	吠费沸肺	啡肥菲非诽飞匪
度	肚渡踱堕舵杜惰跺驮镀妒	牍朵夺堵躲督毒都读多睹独赌
座	凿坐作做	昨左
庭	蜓廷亭停	厅艇听挺
庵	鞍安氨	按案暗岸俺
庶	树疏术数述竖束署曙恕墅漱	暑梳殊枢黍输鼠薯叔属蜀淑书蔬舒赎熟抒
康	糠慷	抗扛炕
庸	拥佣	泳蛹踊用咏勇永
廉	帘怜连镰莲联	恋练脸敛炼链
廊	狼琅郎榔	浪朗
廓	扩括阔
延	炎颜阎沿研癌盐言严	淹谚咽唁演艳焰掩奄宴雁烟验殷衍燕堰眼厌砚
廷	庭蜓亭停	厅艇听挺
建	践溅鉴渐健荐监件涧键舰间贱剑见箭	坚柬拣捡茧兼简尖检剪俭艰碱减煎歼肩奸
开	揩	咳凯慨楷岂
异	腋邑逸艺肄掖亦意抑义溢疫役易忆翼衣益亿奕液毅译绎屹艾一议谊	夷疑医仪伊漪依已以倚椅乙遗移姨胰宜尾揖蛇蚁矣壹
弃	泣器迄气砌汽契企妻	戚稽畦漆脐七只鳍奇凄祈骑枝旗启栖欺起歧柒乞棋齐其溪崎岂期
弄		农浓脓
弊	庇毙臂毕币必避辟泌壁碧璧闭比蔽鄙	逼彼鼻匕笔
式	拭势逝室是使柿侍市士世饰适誓试氏视恃示识事释嗜	提匙施时屎驶拾狮实诗食什石十史射尸失硕虱蚀矢始师湿
弓	宫共攻蚣躬工公供恭功红	拱汞巩贡矿
引	瘾隐听饮蚓	印吟淫银因殷茵音姻阴
弛	匙驰池迟持	翅斥赤吃尺嗤齿耻侈
弟	的蒂递帝第地缔	笛抵嘀低嫡滴底涤敌芽
张	章彰樟	丈涨掌长帐胀杖仗账障
弥	谜迷靡糜	密咪蜜米秘觅泌
弦	嫌衔舷涎闲贤咸	仙现馅显掀险陷先腺纤线限铣癣鲜献县宪
弧	壶狐胡葫糊蝴湖	许呼沪互戏唬户乎护虎忽
弯	豌湾	玩顽万腕碗宛娩丸完惋婉晚挽
弱	若
弹	檀淡痰石坛昙氮担蛋谈谭旦但潭诞	贪瘫丹单毯胆碳摊叹耽探滩袒坦炭
强	将酱抢匠墙降	桨姜浆江蒋僵疆讲呛枪缰奖腔
归	傀规瑰龟闺	跪鬼诡桂柜贵轨
当	铛裆	挡荡档党
当	铛裆荡挡	档党
录	露鹿氯陆路赂碌	卢炉卤芦颅鲁庐虏
形	邢行刑型	醒腥星性兴姓猩杏幸省
彤	桐铜童同瞳	统筒桶痛通
彩	采踩睬	菜财材猜才裁
彪	标膘	表
彬	缤宾滨濒	鬓
彭	棚膨硼鹏篷澎蓬朋	捧碰烹砰
彰	章张樟	丈涨掌长帐胀杖仗账障
影	景颖	鹦婴蝇应映缨赢萤硬荧莺营迎英樱莹盈鹰
役	腋邑逸艺肄掖亦意抑义溢疫异易忆翼衣益亿奕液毅译绎屹艾一议谊	夷疑医仪伊漪依已以倚椅乙遗移姨胰宜尾揖蛇蚁矣壹
彻	撤澈辙	车扯
彼	匕笔比鄙	逼庇壁毙碧璧臂毕闭鼻弊币必避蔽泌辟
往	网枉	旺忘妄王亡望汪
征	丁正筝怔症狰睁挣蒸争	政整郑证拯
征	址正止纸趾症狰筝怔争只丁指旨睁挣蒸	植致整治制直脂窒掷氏织帜执稚蜘之郑志拯智挚政枝肢值职至支秩吱置证汁芝知滞殖识质
径	境竞静净劲敬靖竟镜	颈兢惊鲸经精睛阱荆茎井警京更景晶
待	贷戴袋带大代逮呆怠	歹
很	狠	痕恨
徊	怀淮槐	坏
律	氯滤绿虑率	侣履屡旅娄驴缕铝吕
徐		叙畜绪恤酗旭蓄许需序虚絮婿吁续须
徒	凸涂图突屠途	土吐兔秃
得	德的
徘	排牌	拍湃派
徙	洗喜	悉熙厘习畦惜锡戏媳隙牺西希膝息栖吸携晰熄析席夕行系袭昔犀稀溪嬉蟋细
御	域裕玉愈尉育誉浴寓欲芋狱郁与豫预遇语吁谷喻	逾予雨屿迂于愉渔榆鱼娱舆隅愚羽淤宇
循	巡寻旬询驯	逊讯训勋迅汛殉
微	为薇维围违唯危巍桅	委卫位喂胃未味威偎慰谓苇畏伪尉遗萎纬蔚伟尾魏
德	得	的
徽	恢堕挥辉灰	虫茴惠晦讳贿汇回绘毁悔诲慧会溃秽蛔
心	欣薪新辛锌芯	衅信寻
必	庇毙臂毕弊币避辟泌壁碧璧闭比蔽鄙	逼彼鼻匕笔
忆	腋邑逸艺肄掖亦意抑义溢疫异役易翼衣益亿奕液毅译绎屹艾一议谊	夷疑医仪伊漪依已以倚椅乙遗移姨胰宜尾揖蛇蚁矣壹
忌	际纪妓荠祭季记剂系既计鲫继技济寄冀骑	叽稽给籍即吃棘脊唧借急几嫉迹基集级箕寂饥及奇挤积畸吉讥激绩辑居机击圾肌其己鸡期极疾
忍		赁认韧纫人刃儿仁任
志	智挚致治制至秩置窒知滞帜识稚质	址植直脂掷只氏征织执蜘之枝肢值止纸趾职支吱汁芝殖指旨
忘	王旺妄望	往网枉亡汪
忙	氓盲芒茫	莽
忠	中盅衷终钟	种肿众重仲
忧	悠优幽	佑尤由游友邮犹又油诱有幼右
快	筷会块刽
忱	沈臣晨沉尘陈辰	趁称衬
念		年撵碾捻
忽	呼乎戏	壶许沪互狐唬户胡护葫虎糊蝴弧湖
忿	愤粪奋分份	粉芬吩焚纷氛坟
怀	淮徊槐	坏
态	泰汰太	台抬胎苔
怒		努奴
怔	丁正征筝症狰睁挣蒸争	政整郑证拯
怕	帕	爬趴耙扒
怖	埠步簿部布不	捕补哺卜
怜	帘连镰莲联廉	恋练脸敛炼链
思	司丝斯撕嘶私	死食四饲伺肆似赐寺
怠	贷袋带大待逮代戴	歹呆
急	辑即籍吃棘脊唧借嫉击级寂集及圾吉极疾	纪叽妓稽给荠记几迹既鲫基饥箕继奇济挤积寄畸冀骑讥际激绩居祭机季剂系计技忌肌其己鸡期
性	兴姓杏幸	邢行型刑形醒腥星猩省
怨	愿院远	猿源宛原援园元冤鸳圆辕渊缘袁员
怪		拐乖
怯	切壳契鹊确窃雀却	且茄瘸缺
总		宗棕从纵踪综
恃	拭势逝室是使柿侍市士世饰适誓试氏视示式识事释嗜	提匙施时屎驶拾狮实诗食什石十史射尸失硕虱蚀矢始师湿
恋	敛练炼链	帘怜连脸镰莲联廉
恍	幌谎晃	黄荒皇慌煌凰惶蝗
恐	孔	控空
恒	横衡	哼
恕	树疏术数述竖庶束署曙墅漱	暑梳殊枢黍输鼠薯叔属蜀淑书蔬舒赎熟抒
恢	堕挥辉徽灰	虫茴惠晦讳贿汇回绘毁悔诲慧会溃秽蛔
恤	叙畜绪酗序絮旭婿蓄续	许徐需虚须吁
恨		痕很狠
恬	填甜田	添天舔
恭	宫弓共攻蚣躬工公供功红	拱汞巩贡矿
息	习袭媳昔惜熄席锡	悉熙厘畦徙戏隙西喜牺希膝栖吸洗携晰析系行夕犀稀溪嬉蟋细
恰	洽	卡
恳	肯垦啃
恶	愕于务雾巫诬悟乌屋俄扼噩勿遏饿鳄晤误物坞呜污哑	阿蜈无舞伍额芜鹉梧讹亡午五捂武侮鹅蛾吴
恼	脑	挠闹
悄	巧鹊雀	窍桥侨峭锹跷瞧撬憔壳乔翘俏敲
悉	膝熙厘畦栖吸携晰析行西牺犀稀嬉希溪蟋	徙习戏息系袭细隙媳喜惜洗昔熄席锡夕
悍	旱焊翰撼憾捍汗汉	罕韩喊寒和函涵含酣
悔	虫贿毁诲会	恢茴堕惠晦讳汇挥回绘辉徽灰慧溃秽蛔
悟	勿务晤雾物坞误恶	无于伍巫诬午乌吴舞梧武五呜污芜亡屋蜈捂侮鹉
悠	优忧幽	佑尤由游友邮犹又油诱有幼右
患	唤换幻痪宦焕涣	缓环欢还
悦	越阅耀岳药粤跃说乐钥月	约
悬	漩玄旋县	喧选炫轩宣
悯	敏皿闽	民
悲	杯背碑卑	臂贝被辈焙狈惫北备倍
悴	翠脆粹	催崔衰摧
悼	道到稻盗倒导蹈	叨刀岛祷捣
情	请倾晴擎	亲氢庆卿顷轻清蜻青
惊	鲸兢经精睛荆茎京更晶	颈径境竞静阱景净井劲靖警敬竟镜
惋	玩腕万	顽娩碗宛丸豌完湾婉晚弯挽
惑	豁或获货祸霍	活和伙火
惕	屉涕剃替	剔梯提体啼蹄堤题踢
惜	习袭息媳昔熄席锡	悉熙厘畦徙戏隙西喜牺希膝栖吸洗携晰析系行夕犀稀溪嬉蟋细
惠	诲讳贿汇绘晦慧会溃秽	恢虫茴堕回挥辉毁徽悔灰蛔
惦	店垫殿甸玷淀佃奠电	颠典点碘
惧	聚巨剧距具拒俱炬句锯据足	拘鞠蛆沮居车橘驹矩举局菊
惨		惭残餐灿蚕参
惩	呈成城程诚承乘盛橙澄	称秤撑逞
惫	臂背贝被辈焙狈备倍	卑悲杯北碑
惭	蚕残	惨参餐灿
惯	观冠贯罐灌	馆管官棺关
惰	踱堕舵跺驮度	躲朵夺多
想	享响	像祥向箱镶巷详湘象降橡相项乡厢翔香
惶	黄皇煌凰蝗	恍谎荒慌晃幌
惹	若	热
愁	稠绸畴筹仇酬	臭抽丑
愈	域裕玉尉育誉浴寓欲芋御狱郁与豫预遇语吁谷喻	逾予雨屿迂于愉渔榆鱼娱舆隅愚羽淤宇
愉	逾予于渔娱鱼榆舆隅愚	屿愈浴淤狱与豫遇羽语谷喻域裕雨玉尉育誉寓欲御迂郁预吁芋宇
意	腋邑逸艺肄掖亦抑义溢疫异役易忆翼衣益亿奕液毅译绎屹艾一议谊	夷疑医仪伊漪依已以倚椅乙遗移姨胰宜尾揖蛇蚁矣壹
愕	噩俄遏饿恶鳄扼哑	阿额讹鹅蛾
愚	逾予愉于渔娱鱼榆舆隅	屿愈浴淤狱与豫遇羽语谷喻域裕雨玉尉育誉寓欲御迂郁预吁芋宇
感	赶敢秆杆橄	干肝竿甘柑
愤	粪奋分份忿	粉芬吩焚纷氛坟
愧	溃	葵傀窥魁盔亏
愿	怨院远	猿源宛原援园元冤鸳圆辕渊缘袁员
慈	瓷词雌祠辞磁	厕刺此伺差赐次
慌	荒	黄恍谎皇晃煌凰幌惶蝗
慎	肾甚渗	沈伸呻审婶信申绅深参身神
慕	幕募木暮沐目牧墓穆睦	亩姥姆母拇模牡
慢	漫蔓幔曼	瞒蛮满馒
慧	惠讳贿汇绘晦诲会溃秽	恢虫茴堕回挥辉毁徽悔灰蛔
慨	楷咳岂凯	揩开
慰	为卫谓位尉喂伪胃未味遗蔚魏畏	委伟尾薇苇违维围威偎萎纬唯危微巍桅
慷	糠康	抗扛炕
憎	增曾	赠
憔	桥侨瞧乔翘	巧窍峭锹跷撬壳俏鹊敲悄雀
憾	旱焊悍翰撼捍汗汉	罕韩喊寒和函涵含酣
懂	董	东冻栋冬洞动
懈	骇屉谢屑蟹卸契泻楔解械	鞋写挟协些携谐歇斜邪血胁
懊	澳傲奥拗	袄熬凹
懒	榄览缆揽	拦蓝澜篮烂栏兰滥
懦	糯诺	挪娜
戈	搁割胳哥鸽疙歌	阁合格革隔葛蛤各个
戏	呼系乎隙忽夕细	悉熙狐沪厘习畦唬惜虎胡锡湖徙媳西喜牺希弧膝互息栖户吸洗携葫晰熄析席许壶行袭昔犀稀嬉溪蟋护糊蝴
成	呈惩城程诚承乘盛橙澄	称秤撑逞
戒	届介界借解诫芥	接节杰竭截揭阶皆街劫捷姊结洁姐
或	获货祸霍惑	豁和伙活火
战	栈暂占站蘸绽颤	盏沾瞻崭毡斩展
戚	漆栖凄溪欺柒妻七	泣迄畦稽脐只鳍气奇砌契企祈骑枝启旗歧起器乞棋弃汽齐其崎岂期
截	节杰竭劫捷结洁	接揭皆阶届街界介姊借解诫戒姐芥
戳		绰
戴	贷袋带大待逮代怠	歹呆
户	沪互护	壶许呼狐戏唬乎胡葫虎忽糊蝴弧湖
房	肪防坊妨	芳放访纺方仿
所	锁琐索	缩唆嗦梭
扁	偏篇翩匾贬	片辫蝙便辨辩遍变边鞭编骗
扇	衫山善杉单删珊赡擅膳	闪陕
手	守首	售收熟兽瘦受授寿
才	财材裁	菜采踩猜彩睬
扎	炸喳渣查闸	眨栅诈乍
扑	铺仆	瀑菩葡朴浦谱暴蒲圃普脯
扒	八爬巴捌耙笆芭疤吧叭	爸靶霸把伯罢趴拔跋坝帕怕
打		大达答搭瘩
扔		仍
托	脱拖	椭唾拓驮驼鸵妥
扛	岗纲冈缸肛钢刚	糠慷抗港炕康
扣	寇	口
执	植值殖职直质掷	址治致制脂窒只氏征织帜稚蜘之志智挚枝肢止纸趾至支秩吱置汁芝知滞指识旨
扩	括阔廓
扫	嫂	骚艘搔
扬	杨洋阳羊	鸯养样痒秧殃氧仰央漾
扭	钮纽	牛拗
扮	半拌伴绊办瓣	班板扳搬颁版般斑
扯		撤澈车辙彻
扰		绕饶
扳	班搬颁般斑	拌扮半伴板版绊办瓣
扶	芙辐蝠浮福幅服缚俘袱符伏拂夫	妇赴腹麸付脯附赋斧父负甫敷傅咐肤抚俯府辅富复孵腐副
批	匹霹坏被劈披	屁否脾罢啤疲譬皮僻辟
扼	噩愕俄遏饿恶鳄哑	阿额讹鹅蛾
找	沼爪	昭赵罩招嘲召朝兆着照
承	呈成惩程城诚乘盛橙澄	称秤撑逞
技	际纪妓荠祭季记剂系既计鲫继济忌寄冀骑	叽稽给籍即吃棘脊唧借急几嫉迹基集级箕寂饥及奇挤积畸吉讥激绩辑居机击圾肌其己鸡期极疾
抄	钞剿超	嘲潮吵朝炒巢
把	靶	八巴伯罢笆芭疤跋吧叭爸霸扒捌耙拔坝
抑	腋邑逸艺肄掖亦意义溢疫异役易忆翼衣益亿奕液毅译绎屹艾一议谊	夷疑医仪伊漪依已以倚椅乙遗移姨胰宜尾揖蛇蚁矣壹
抒	疏殊枢梳输书蔬舒	术鼠曙束署暑属庶恕漱熟树黍叔薯述蜀赎淑数竖墅
抓		爪
投	头	偷透
抖	蚪斗陡	痘都读逗兜豆
抗	炕	糠慷扛康
折	摘辙哲	遮宅浙蔗者
抚	腐斧父俯甫府辅脯	妇赴辐浮缚腹符麸伏拂付附赋福俘负袱夫芙敷傅蝠咐肤富复幅服孵扶副
抛		跑刨炮袍咆泡
抡	仑轮伦论沦
抢	将强闯呛枪腔	窗幢囱床疮墙撞创
护	户沪互	壶许呼狐戏唬乎胡葫虎忽糊蝴弧湖
报	爆暴刨豹抱	褒堡饱包薄雹苞保宝胞
披	匹霹批坏被劈	屁否脾罢啤疲譬皮僻辟
抬	台苔	胎泰太汰态
抱	爆暴刨豹报	褒堡饱包薄雹苞保宝胞
抵	底	嘀蒂嫡帝芽缔笛的弟低递滴第涤敌地
抹		默漠磨墨脉么莫沫陌魔摸茉末蘑膜摩寞摹模没
押	牙压蚜鸭鸦呀涯衙芽	轧雅讶亚哑
抽		臭稠绸畴筹丑愁仇酬
拂	芙辐蝠浮福幅服缚俘袱符扶伏夫	妇赴腹麸付脯附赋斧父负甫敷傅咐肤抚俯府辅富复孵腐副
拄	贮煮主属嘱	助朱住注蛛猪柱筑术珠祝铸轴竹烛蛀诸逐驻株
担	诞弹单石氮旦耽蛋丹但淡	胆
拆	差	柴豺
拇	亩姥姆母牡	幕募木慕暮沐目牧墓穆模睦
拉	喇啦	辣落蜡腊
拌	半扮伴绊办瓣	班板扳搬颁版般斑
拍		排牌派徘湃
拐		怪乖
拒	聚巨剧距具俱惧炬句锯据足	拘鞠蛆沮居车橘驹矩举局菊
拓	唾	拖椭托脱驮驼鸵妥
拔	跋	八巴伯罢笆芭疤吧叭爸靶霸扒捌把耙坝
拖	托脱	椭唾拓驮驼鸵妥
拗	澳耀奥药懊乐钥要傲	袄肴咬姚夭舀扭窑侥摇么哟淆腰遥钮纽牛凹谣吆邀熬妖
拘	蛆沮居车俱驹锯	鞠聚巨剧距橘具拒惧炬举矩局句据菊足
拙	卓浊茁灼着啄琢酌	桌捉
招	昭嘲朝着召	赵罩找爪兆沼照
拜	败	白百摆
拟	你	尼呢逆溺泥匿腻
拢	垄	咙龙隆胧窿笼聋
拣	柬捡茧检简俭剪减碱	践尖建鉴歼健监涧键兼贱肩箭溅渐荐坚艰舰煎间件剑见奸
拥	泳佣蛹踊咏勇庸永	用
拦	蓝澜篮栏兰	览懒榄缆烂揽滥
拧	凝狞柠宁	泞
拨	剥玻播般菠	泊舶渤搏勃驳白柏伯跛博卜簸薄脖膊荸
择	窄泽贼则责	怎侧
括	阔扩瓜廓蜗刮	卦挂寡褂
拭	势逝室是使柿侍市士世饰适誓试氏视恃示式识事释嗜	提匙施时屎驶拾狮实诗食什石十史射尸失硕虱蚀矢始师湿
拯	整	丁政正征筝怔证症狰郑睁挣蒸争
拱	巩矿共汞	宫红弓攻蚣躬工公贡恭功供
拳	泉卷权痊犬全	劝圈券
拴	栓	涮
拷	考烤	铐靠
拼		频贫濒品聘
拾	提硕时舍蚀叶涉摄设社实食什石十射赦	拭匙势室施屎使柿侍驶饰誓狮氏舌诗恃示奢式史事释嗜适尸失逝是虱士市世赊矢试视甚识蛇始师湿
拿		哪那呐纳捺钠娜
持	匙驰池迟弛	翅斥赤吃尺嗤齿耻侈
挂	卦褂	刮寡瓜蜗括
指	只址征止纸趾旨	植治致制直脂窒掷氏织帜执稚蜘之志智挚枝肢值职至支秩吱置汁芝知滞殖识质
按	岸案暗	鞍庵氨俺安
挑		跳条调
挖	洼蛙	娃瓦袜
挚	智知致治滞帜质识稚至制秩置志窒	址植直脂掷只氏征织执蜘之枝肢值止纸趾职支吱汁芝殖指旨
挟	鞋狭洽匣暇携谐霞斜邪夹胁荚协峡侠颊辖	屉钾价瞎甲歇嘉写卸家契些稼下吓解嫁厦假架骇佳屑加蟹楔懈夏械驾谢虾泻贾血茄
挠		脑恼闹
挡	党荡档当	铛裆
挣	丁政正征筝证症狰郑睁怔蒸争	拯整
挤	给济脊己几	纪妓叽即稽籍荠吃棘唧借记急嫉迹既鲫基集级寂及饥箕继奇积寄畸冀吉骑讥际激绩辑居祭机季剂击系计技忌圾肌其鸡期极疾
挥	恢堕辉徽灰	虫茴惠晦讳贿汇回绘毁悔诲慧会溃秽蛔
挨	哀哎唉埃	蔼碍爱艾隘矮
挪	娜	糯懦诺
挫	锉撮措错	搓
振	阵震枕镇	诊疹侦珍斟榛针贞真
挺	艇	听庭蜓廷停亭厅
挽	宛娩碗婉晚	玩顽万腕丸豌完惋湾弯
捂	武舞伍侮午鹉五	无于务雾巫诬乌吴勿梧呜污芜悟亡屋恶蜈晤误物坞
捆		困坤昆
捉	桌	卓浊茁灼拙着啄琢酌
捌	八巴扒笆芭疤吧叭	爸靶霸把伯耙罢拔跋坝
捍	旱焊悍翰撼憾汗汉	罕韩喊寒和函涵含酣
捎	稍烧梢	芍少勺绍召哨
捏		聂镊孽
捐	鹃圈身	倦眷卷绢
捕	补哺卜	埠步不怖部布簿
捞		劳烙牢姥老酪唠络
损	笋	孙
捡	柬拣茧检简俭剪减碱	践尖建鉴歼健监涧键兼贱肩箭溅渐荐坚艰舰煎间件剑见奸
换	唤幻痪宦焕涣患	缓环欢还
捣	导倒岛祷	道叨悼到稻盗刀蹈
捧		棚膨碰砰硼鹏篷烹朋蓬澎彭
据	聚巨剧距具拒俱惧炬句锯足	拘鞠蛆沮居车橘驹矩举局菊
捶	椎垂锤	吹炊
捷	节杰竭截劫结洁	接揭皆阶届街界介姊借解诫戒姐芥
捺	那钠呐纳娜	拿哪
捻	撵碾	年念
掀	鲜仙先纤	嫌馅衔弦险腺线涎舷癣闲贤县咸现显陷限铣献宪
授	售兽瘦受寿	收首守手熟
掉	吊钓调	雕刁叼碉
掌	涨长	丈彰帐胀樟杖仗张账障章
掏	涛滔	萄逃淘陶讨套桃
排	徘牌	拍湃派
掖	腋邑逸艺肄亦意抑义溢疫异役易忆翼衣益亿奕液毅译绎屹艾一议谊	夷疑医仪伊漪依已以倚椅乙遗移姨胰宜尾揖蛇蚁矣壹
掘	倔决觉角绝诀爵脚嚼
掠	略
探	贪瘫摊碳叹滩炭	弹檀毯痰坛昙谈袒谭坦潭
接	揭皆阶街结	节杰竭截届界介劫捷借解诫戒姊姐洁芥
控	空	恐孔
推		蜕退颓腿
掩	眼演衍	谚咽炎淹焰艳颜奄延雁烟验沿堰癌厌砚唁严阎殷宴研燕盐言
措	锉挫撮错	搓
掷	植值殖执职直质	址治致制脂窒只氏征织帜稚蜘之志智挚枝肢止纸趾至支秩吱置汁芝知滞指识旨
掺	搀	馋单蝉阐产铲缠
揉	柔蹂	肉
揍	奏骤	走
描	瞄苗	庙秒妙渺藐
提	硕实啼食时什石十蚀蹄拾堤射题	拭惕体屉匙室施势屎使柿侍驶饰誓狮氏剔诗恃示剃式史事释嗜适尸涕失逝是虱士市世矢试视梯替识始师湿踢
插	喳叉差	刹察岔查茶
揖	衣医伊一依壹漪	夷疑艺肄意抑仪疫异忆翼益奕液毅屹艾已议以倚谊腋邑逸掖椅乙亦义溢遗移役易姨胰宜尾亿译绎蛇蚁矣
握	沃卧	窝涡我
揩	开	咳凯慨楷岂
揪	鸠纠	就九舅酒久韭灸臼疚救旧究玖
揭	接皆阶街结	节杰竭截届界介劫捷借解诫戒姊姐洁芥
援	猿源辕原缘园元袁员圆	远宛渊愿怨冤鸳院
揽	懒榄览缆	拦蓝澜篮烂栏兰滥
搀	掺	馋单蝉阐产铲缠
搁	戈割胳哥鸽疙歌	阁合格革隔葛蛤各个
搂	篓	露漏陋楼娄
搅	侥较矫狡绞饺角搞剿稿脚缴	轿叫糕窖膏椒高胶羔篙娇嚼蕉焦告教校郊交觉礁骄浇
搏	泊舶渤勃白柏伯博卜脖薄驳膊荸	剥跛簸玻播拨般菠
搓	撮	锉挫措错
搔	骚艘	嫂扫
搜		嗽
搞	稿搅	高糕羔篙告膏
搪	堂唐糖棠膛塘	淌躺趟烫倘汤
搬	班扳颁般斑	拌扮半伴板版绊办瓣
搭	答瘩	大达打
携	悉膝熙鞋厘畦栖挟吸谐晰斜邪析胁行协西牺犀稀嬉希溪蟋	屉习惜歇锡徙戏写媳隙喜卸些契解骇屑息蟹洗楔懈械熄席系夕谢袭昔泻血细
摄	社射舍叶拾涉赦设	甚舌什奢蛇赊
摆	百	白拜败
摇	侥淆遥肴谣窑姚	么耀夭哟舀腰药乐咬吆要拗钥邀妖
摊	贪瘫探滩	弹檀毯痰坛碳叹昙炭谈袒谭坦潭
摔	衰	蟀帅甩率
摘	斋折哲齐辙	窄宅遮债蔗浙祭这着责寨者
摧	催崔衰	悴翠脆粹
摩	磨蘑膜魔摹模	默漠么墨脉末沫莫寞陌抹摸茉没
摸		默漠磨墨脉么莫沫陌抹魔茉末蘑膜摩寞摹模没
摹	磨蘑膜摩魔模	默漠么墨脉末沫莫寞陌抹摸茉没
撑	称	呈惩成秤城诚程承乘逞盛橙澄
撒	洒	萨飒
撕	司丝思斯嘶私	死食四饲伺肆似赐寺
撞	壮幢状床	装妆抢窗囱闯庄疮创桩
撤	澈辙彻	车扯
撩	聊疗缭辽寥潦燎僚嘹	了料
撬	窍锹峭跷壳翘俏敲	巧桥侨瞧憔乔鹊悄雀
播	剥菠簸薄拨般玻	泊舶渤搏勃驳柏白伯跛博卜脖膊荸
撮	锉错挫搓措
撰	传赚转	专砖
撵	碾捻	年念
撼	旱焊悍翰憾捍汗汉	罕韩喊寒和函涵含酣
擂	累泪类雷	垒儡勒蕾
擅	善单扇赡膳	闪衫山陕杉删珊
操	糙	草槽曹
擎	倾情晴	亲氢庆卿顷轻请清蜻青
擒	勤秦琴禽芹	侵亲钦寝
攀	潘	胖叛判般盘畔盼
攘	瓤壤嚷	让
支	只氏芝枝肢知织蜘之吱脂汁	址植治致制直窒掷征帜执稚志智挚值止纸趾职至秩置滞殖指识旨质
收		售首守兽瘦寿授受手熟
改		概丐该溉盖钙
攻	宫弓共蚣躬公工供恭功红	拱汞巩贡矿
放		芳房妨访坊纺肪防方仿
政	正郑症证挣	丁征整睁拯狰筝怔蒸争
故	估雇告顾固	孤沽辜股凸古家咕鼓姑滑贾骨谷
效	孝肖笑酵校啸	嚣晓哮削宵小硝箫销萧学消
敌	笛的嘀嫡涤芽	弟抵蒂低递帝滴底第地缔
敏	皿闽悯	民
救	就舅臼旧疚究	九酒久揪鸠韭灸纠玖
教	轿叫蕉焦窖浇校郊交椒觉胶骄礁娇较	矫侥搅狡绞饺角剿脚嚼缴
敛	恋炼练链	帘怜连脸镰莲联廉
敞	场厂	唱长昌偿畅常尝肠裳倡猖
敢	感赶秆杆橄	干肝竿甘柑
散	伞	三参
敦	墩蹲	囤吨盹盾顿钝
敬	径境竞静净劲靖竟镜	颈兢惊鲸经精睛阱荆茎井警京更景晶
数	蟀树硕黍术鼠薯曙述蜀束署勺暑帅疏烁属竖庶率恕墅漱	梳殊枢输叔淑说书蔬舒赎熟抒
敲	跷撬锹	巧桥侨峭瞧憔壳乔俏悄窍翘鹊雀
整	拯	丁政正征筝怔证症狰郑睁挣蒸争
敷	肤麸孵夫	妇赴辐浮缚腹符伏拂付脯附赋斧福父俘负袱甫芙傅蝠咐抚俯府辅富复幅服扶腐副
文	免问紊蚊闻纹	吻瘟温稳
斋	齐摘	窄宅债祭责寨
斑	班扳搬颁般	拌扮半伴板版绊办瓣
斗	蚪陡抖	痘都读逗兜豆
斗	逗豆痘读	陡都兜蚪抖
料	燎了	撩聊疗缭辽寥潦僚嘹
斜	鞋狭洽匣协挟暇峡侠携谐霞邪辖胁	屉瞎歇写卸契些下吓解厦骇屑蟹楔懈夏械谢虾泻血
斟	诊侦珍榛针贞真	阵振枕震疹镇
斤	津金巾禁浸今筋襟	进尽锦紧劲仅谨近晋
斥	赤翅	匙弛驰池迟持吃尺嗤齿耻侈
斧	腐父抚俯甫府辅脯	妇赴辐浮缚腹符麸伏拂付附赋福俘负袱夫芙敷傅蝠咐肤富复幅服孵扶副
斩	崭盏展	栈暂毡战占沾站瞻蘸绽颤
断	锻段缎	短端
斯	司丝思撕嘶私	死食四饲伺肆似赐寺
新	欣薪辛锌芯	衅信寻
方	芳坊	房妨放访纺肪防仿
施	狮失诗虱师湿尸	拭提匙势室时屎使柿侍驶拾饰誓氏实食恃什示石十式史事射释适嗜硕逝是市士蚀世矢试视识始
旁	傍蚌谤膀磅螃棒庞	梆胖榜帮乓邦绑
旅	侣履屡娄缕铝吕	氯滤律绿虑驴率
旋	炫漩玄悬还县	喧宣轩选
族	卒足	阻诅租祖组
旗	只鳍枝棋畦奇齐其崎脐祈歧骑期	泣迄戚稽漆妻七气砌契凄企启栖欺柒起器乞弃汽溪岂
无	蜈芜巫诬亡梧吴	于务伍雾午乌舞勿武五呜污悟屋恶晤误物坞捂侮鹉
既	际纪妓荠祭季记剂系计鲫继技济忌寄冀骑	叽稽给籍即吃棘脊唧借急几嫉迹基集级箕寂饥及奇挤积畸吉讥激绩辑居机击圾肌其己鸡期极疾
旦	诞弹石氮担蛋但淡	单胆耽丹
旧	就舅臼救疚究	九酒久揪鸠韭灸纠玖
旨	只址征止指纸趾	植治致制直脂窒掷氏织帜执稚蜘之志智挚枝肢值职至支秩吱置汁芝知滞殖识质
早	澡藻蚤枣	皂躁造糟灶噪遭燥凿
旬	巡寻询驯循	逊讯训勋迅汛殉
旭	叙畜绪恤酗序絮婿蓄续	许徐需虚须吁
旱	焊悍翰撼憾捍汗汉	罕韩喊寒和函涵含酣
时	硕实提食什石十蚀拾射	拭匙势室施屎使柿侍驶饰誓狮氏诗恃示式史事释适嗜尸失逝是虱士市世矢试视识始师湿
旷	框眶矿况	筐狂
旺	王望忘妄	往网枉亡汪
昂		肮
昆	坤	捆困
昌	倡猖	场唱长偿厂畅常尝肠裳敞
明	鸣铭螟名	命
昏	婚荤	浑魂混
易	腋邑逸艺肄掖亦意抑义溢疫异役忆翼衣益亿奕液毅译绎屹艾一议谊	夷疑医仪伊漪依已以倚椅乙遗移姨胰宜尾揖蛇蚁矣壹
昔	习袭息媳惜熄席锡	悉熙厘畦徙戏隙西喜牺希膝栖吸洗携晰析系行夕犀稀溪嬉蟋细
昙	弹檀痰坛谈谭潭	贪瘫毯碳叹炭探滩袒坦摊
星	腥兴猩	邢行型刑形醒性姓杏幸省
映	应硬	鹦婴蝇缨赢萤荧莺影营迎莹英樱景颖盈鹰
春		醇唇蠢淳纯
昧	媚妹	美媒煤每霉枚梅楣玫眉没
昨	作	做坐凿左座
昭	嘲招朝着召	赵罩找爪兆沼照
昼	咒宙皱	肘舟周州粥洲轴帚
显	险癣铣鲜	仙嫌馅衔弦先腺线涎舷闲贤县咸现掀陷纤限献宪
晃	幌恍谎	黄荒皇慌煌凰惶蝗
晋	进尽劲仅禁浸近	津金斤锦紧巾今谨筋襟
晌	赏上	尚商裳汤伤
晒	杀	筛
晓	小	哮肖削宵笑硝校萧消啸嚣孝箫销酵效学
晕	酝孕运蕴韵员	陨允云耘匀
晚	宛娩碗婉挽	玩顽万腕丸豌完惋湾弯
晤	勿务雾误物坞悟恶	无于伍巫诬午乌吴舞梧武五呜污芜亡屋蜈捂侮鹉
晦	惠讳贿汇绘诲慧会溃秽	恢虫茴堕回挥辉毁徽悔灰蛔
晨	沈臣沉尘陈辰忱	趁称衬
普	圃浦谱	菩瀑仆扑葡朴铺暴蒲脯
景	颈影阱井警颖	兢竞荆茎映赢镜硬经鲸营迎净莹晶盈鹰惊径境婴鹦蝇应靖缨京竟萤荧精莺静睛英劲敬樱更
晰	悉膝熙厘畦栖吸携析行西牺犀稀嬉希溪蟋	徙习戏息系袭细隙媳喜惜洗昔熄席锡夕
晴	倾情擎	亲氢庆卿顷轻请清蜻青
晶	鲸兢惊精经睛荆茎京更	颈径境竞静阱景净井劲靖警敬竟镜
智	挚知致治滞帜质识稚至制秩置志窒	址植直脂掷只氏征织执蜘之枝肢值止纸趾职支吱汁芝殖指旨
晾	凉量谅亮辆	两俩良粮梁粱
暂	栈战占站蘸赞绽颤	盏沾瞻咱崭毡斩展
暇	狭匣洽厦挟峡侠下夏吓霞斜辖	瞎虾
暑	黍鼠属薯数蜀署	术曙束书庶恕漱舒熟树梳叔述赎抒疏殊枢输淑竖蔬墅
暗	岸案按	鞍庵氨俺安
暮	幕募木慕沐目牧墓穆睦	亩姥姆母拇模牡
暴	爆瀑铺刨豹抱报	菩饱薄苞保胞脯朴雹褒宝普扑仆葡堡谱蒲圃浦包
曙	树疏术数述竖庶束署恕墅漱	暑梳殊枢黍输鼠薯叔属蜀淑书蔬舒赎熟抒
曲	圈屈蛆趋躯取岖娶驱区	漆趣渠去
更	鲸兢惊精经睛荆耕茎羹京晶	颈径境竞埂静阱梗景净井劲靖耿敬警竟镜
曹	槽	草操糙
曼	漫蔓幔慢	瞒蛮满馒
曾	憎增层	赠
替	屉涕剃惕	剔梯提体啼蹄堤题踢
最	醉罪	嘴堆
月	悦越阅耀岳药粤跃说乐钥	约
有	佑友又诱幼右	忧幽尤悠由犹游邮油优
朋	棚膨硼鹏篷蓬澎彭	捧碰烹砰
服	芙辐蝠浮福幅缚俘袱符扶伏拂夫	妇赴腹麸付脯附赋斧父负甫敷傅咐肤抚俯府辅富复孵腐副
朗		琅浪廊狼郎榔
望	王旺忘妄	往网枉亡汪
朝	昭嘲招潮巢着召	赵罩找爪抄吵钞超兆炒剿沼照
期	激绩叽枝旗畦稽居鸡唧机脐歧几迹只鳍基饥箕棋奇肌积齐其畸崎祈骑讥	纪泣迄妓戚漆籍荠即吃棘脊借记急妻嫉七既鲫级寂气集及继砌济契挤寄凄企冀吉际启辑栖祭欺季柒剂起击系计器乞弃技圾汽忌溪己岂极疾
朦	萌盟檬蒙	梦锰猛孟
木	幕募慕暮沐目牧墓穆睦	亩姥姆母拇模牡
未	为卫谓位尉喂伪胃味遗慰蔚魏畏	委伟尾薇苇违维围威偎萎纬唯危微巍桅
末	默漠磨墨脉沫莫膜陌寞茉没	么蘑摩魔抹摸摹模
本		笨奔
术	树疏数述竖庶束署曙恕墅漱	暑梳殊枢黍输鼠薯叔属蜀淑书蔬舒赎熟抒
术	筑轴竹烛逐	助朱贮煮住注猪主珠柱蛛祝属铸拄蛀诸嘱驻株
朱	蛛猪珠诸株	助贮煮住注主柱筑术祝属铸轴拄竹烛蛀嘱驻逐
朴	脯泊菩仆葡魄蒲破迫	剖瀑扑婆浦谱铺暴颇坡波圃普泼
朴	菩仆葡蒲脯	瀑浦谱暴铺圃普扑
朵	躲多	夺踱堕舵惰跺驮度
机	激绩叽稽居唧几迹基饥箕奇肌其积畸鸡期讥	纪妓即给籍荠吃棘脊借急记嫉既鲫级集寂及继济挤寄冀吉骑际辑祭季剂击系计技忌圾己极疾
朽	宿	锈臭羞袖休嗅秀修绣
杀	晒沙砂煞杉纱	霎厦傻筛
杂	砸咱
权	泉卷拳犬痊全	劝圈券
杆	干肝竿甘柑	感赶敢秆橄
杆	感赶敢秆橄	干肝竿甘柑
杉	衫山沙煞砂删纱珊扇杀	霎闪傻善陕单赡擅厦膳
李	礼理哩里鲤	立吏犁厘黎狸梨砾雳丽痢璃隶沥离粒励厉力荔历莉篱漓例俐利栗
杏	兴性姓幸	邢行型刑形醒腥星猩省
材	财才裁	菜采踩猜彩睬
村		存寸
杖	丈涨长帐胀仗账障	彰掌樟张章
杜	肚渡度镀妒	牍堵督毒都读睹独赌
束	树疏术数述竖庶署曙恕墅漱	暑梳殊枢黍输鼠薯叔属蜀淑书蔬舒赎熟抒
条	调	跳挑
来	莱	癞赖
杨	洋扬阳羊	鸯养样痒秧殃氧仰央漾
杭	行航吭
杯	悲背碑卑	臂贝被辈焙狈惫北备倍
杰	节竭截捷劫结洁	接揭皆阶届街界介姊借解诫戒姐芥
松		宋诵颂送讼耸
板	版	拌扮半伴班扳搬颁绊办瓣般斑
极	辑即籍吃棘脊唧借急嫉击级寂集及圾吉疾	纪叽妓稽给荠记几迹既鲫基饥箕继奇济挤积寄畸冀骑讥际激绩居祭机季剂系计技忌肌其己鸡期
构	够购垢	苟勾沟钩狗句
枉	往网	旺忘妄王亡望汪
析	悉膝熙厘畦栖吸携晰行西牺犀稀嬉希溪蟋	徙习戏息系袭细隙媳喜惜洗昔熄席锡夕
枕	阵诊振震疹镇	侦珍斟榛针贞真
林	临淋鳞琳邻磷	凛赁吝躏
枚	媒煤霉梅楣玫眉没	美每昧媚妹
果	裹	锅国郭过
枝	肢旗畦支吱脐脂歧汁只氏芝鳍知棋织奇齐蜘其之崎祈骑期	址泣植迄戚漆治致稽制直窒掷妻七气征帜砌执契稚凄企志智挚启值栖止纸趾职至秩欺置起柒器乞弃滞殖指汽识旨溪质岂
枢	疏殊梳输书蔬舒抒	术鼠曙束署暑属庶恕漱熟树黍叔薯述蜀赎淑数竖墅
枣	澡藻早蚤	皂躁造糟灶噪遭燥凿
枪	抢将呛腔	墙强
枫	丰疯峰风封锋讽蜂	奉凤缝逢冯
枯	窟哭	酷裤库苦
架	价稼嫁贾假驾	佳荚钾挟加家甲颊夏夹嘉茄
柄	饼禀秉屏丙	冰兵病并
柏	泊舶渤搏勃白伯博卜脖薄驳膊荸	剥跛簸玻播拨般菠
某		谋
柑	干肝竿杆甘	感赶敢秆橄
柒	戚漆栖凄溪欺妻七	泣迄畦稽脐只鳍气奇砌契企祈骑枝启旗歧起器乞棋弃汽齐其崎岂期
染		然燃
柔	揉蹂	肉
柜	桂贵跪	傀归规鬼瑰诡龟闺轨
柠	拧凝狞宁	泞
查	察喳渣茶扎	眨刹诈栅岔炸叉乍差插闸
柬	拣捡茧检简俭剪减碱	践尖建鉴歼健监涧键兼贱肩箭溅渐荐坚艰舰煎间件剑见奸
柱	助住注祝铸蛀驻	朱贮煮蛛主猪拄筑术珠属轴竹烛逐诸嘱株
柳	铆	刘流榴陆硫留瘤溜泵六琉馏
柴	豺	差拆
柿	拭势逝室是使侍市士世饰适誓试氏视恃示式识事释嗜	提匙施时屎驶拾狮实诗食什石十史射尸失硕虱蚀矢始师湿
栅	炸诈乍	眨喳渣查扎闸
标	膘彪	表
栈	暂战占站蘸绽颤	盏沾瞻崭毡斩展
栋	洞动冻	懂董东冬
栏	拦蓝澜篮兰	览懒榄缆烂揽滥
树	疏术数述竖庶束署曙恕墅漱	暑梳殊枢黍输鼠薯叔属蜀淑书蔬舒赎熟抒
栓	拴	涮
栖	悉膝熙戚厘畦漆吸携晰欺柒析妻七行西牺犀凄稀嬉希溪蟋	泣迄稽习惜脐锡只徙鳍气戏奇砌媳隙喜契企祈骑枝启旗息洗起歧熄席系夕器乞棋袭弃昔汽齐其崎岂期细
栗	立吏砾雳丽痢隶沥粒励厉力荔历莉例俐利	李离礼犁厘理哩黎篱狸梨漓璃里鲤
校	孝肖轿叫觉笑窖酵教效较啸	哮削硝椒角胶箫销学娇脚嚼侥矫狡宵蕉绞焦萧消郊嚣搅交晓饺小剿礁骄浇缴
株	朱蛛猪珠诸	助贮煮住注主柱筑术祝属铸轴拄竹烛蛀嘱驻逐
样	漾养	阳羊鸯杨扬痒秧殃氧仰央洋
核	合盖和荷何河禾盒褐	鹤喝吓呵贺赫
根	跟
格	阁合革隔葛蛤	搁戈割胳各哥鸽疙个歌
栽	灾	仔宰在再载
桂	贵跪柜	傀归规鬼瑰诡龟闺轨
桃	萄逃淘陶涛	套掏讨滔
桅	为薇维围违唯危微巍	委卫位喂胃未味威偎慰谓苇畏伪尉遗萎纬蔚伟尾魏
框	况筐旷眶矿	狂
案	岸按暗	鞍庵氨俺安
桌	捉	卓浊茁灼拙着啄琢酌
桐	彤同铜童瞳	统筒桶痛通
桑	丧	嗓
档	党挡	铛裆荡当
桥	侨瞧憔乔翘	巧窍峭锹跷撬壳俏鹊敲悄雀
桦	豁化划画话滑猾华哗	花
桨	蒋讲奖	将姜浆酱江僵强匠疆缰降
桩	妆装庄	壮撞状
桶	筒统	彤桐铜痛同童通瞳
梁	凉量粱良粮	两俩谅晾亮辆
梅	媒煤霉枚楣玫眉没	美每昧媚妹
梆	傍邦帮	蚌谤旁膀榜磅棒绑
梗	耿埂	羹更耕
梢	稍烧捎	芍少勺绍召哨
梦	孟	锰蒙萌猛檬朦盟
梧	蜈无芜巫诬亡吴	于务伍雾午乌舞勿武五呜污悟屋恶晤误物坞捂侮鹉
梨	离犁厘黎篱狸漓丽璃	李理隶沥礼励历莉吏立砾雳痢粒厉哩力荔例俐利里鲤栗
梭	缩嗦唆	锁索琐所
梯	剔踢	屉体提涕啼惕剃替蹄堤题
械	骇屉谢屑蟹卸契泻楔解懈	鞋写挟协些携谐歇斜邪血胁
梳	疏殊枢输书蔬舒抒	术鼠曙束署暑属庶恕漱熟树黍叔薯述蜀赎淑数竖墅
检	柬拣捡茧简俭剪减碱	践尖建鉴歼健监涧键兼贱肩箭溅渐荐坚艰舰煎间件剑见奸
棉	绵眠	免冕娩勉面缅
棋	只鳍枝旗畦奇齐其崎脐祈歧骑期	泣迄戚稽漆妻七气砌契凄企启栖欺柒起器乞弃汽溪岂
棍		滚
棒	傍蚌谤旁磅	梆膀帮榜邦绑
棕	综踪纵宗	从总
棘	辑即籍吃脊唧借急嫉击级集寂及圾吉极疾	纪叽妓稽给荠记几迹既鲫基饥箕继奇济挤积寄畸冀骑讥际激绩居祭机季剂系计技忌肌其己鸡期
棚	膨硼鹏篷澎蓬朋彭	捧碰烹砰
棠	堂唐糖膛搪塘	淌躺趟烫倘汤
棵	磕苛科蝌刻颗	咳坷客课壳渴可克
棺	官观冠关	馆管惯贯罐灌
椅	尾乙蚁矣已以倚	夷疑医艺肄意抑仪伊疫异漪忆翼衣益奕液毅屹艾一依议谊腋邑逸掖亦义溢遗移役易姨胰宜揖亿译绎蛇壹
植	值殖执职直质掷	址治致制脂窒只氏征织帜稚蜘之志智挚枝肢止纸趾至支秩吱置汁芝知滞指识旨
椎	垂锥捶追锤	缀炊赘吹坠
椒	交蕉娇胶焦礁教骄浇郊	矫侥搅狡轿叫觉绞饺角窖剿校脚较嚼缴
椭	妥	拖托唾脱拓驮驼鸵
椰	爷	页咽野夜业叶也冶射谒
楔	骇屉谢屑蟹卸契泻解懈械	鞋写挟协些携谐歇斜邪血胁
楚	础储处	矗锄畜初触橱除厨雏出
楞		冷
楣	媒煤霉枚梅玫眉没	美每昧媚妹
楷	岂慨凯	咳揩开
楼	娄	露漏陋搂篓
概	溉盖丐钙	该改
榄	懒览缆揽	拦蓝澜篮烂栏兰滥
榆	逾予愉于渔娱鱼舆隅愚	屿愈浴淤狱与豫遇羽语谷喻域裕雨玉尉育誉寓欲御迂郁预吁芋宇
榔	狼琅郎廊	浪朗
榕	溶荣绒茸蓉熔容融	冗
榛	诊侦珍斟针贞真	阵振枕震疹镇
榜	膀绑	傍蚌梆旁谤帮磅棒邦
榴	刘流硫留瘤泵琉	铆陆溜柳六馏
槐	怀徊淮	坏
槽	曹	草操糙
樊	烦帆繁凡矾	返范犯泛番饭翻反贩
樟	章张彰	丈涨掌长帐胀杖仗账障
模	磨蘑膜摩魔摹	漠墨脉陌牧茉穆募木姆沐拇牡睦默么莫沫暮抹母目摸幕姥亩慕末墓寞没
横	恒衡	哼
樱	莺婴鹦英应缨鹰	荧影营迎莹蝇映赢萤景颖硬盈
橄	感赶敢秆杆	干肝竿甘柑
橘	局鞠菊	聚蛆沮居车具俱炬举锯句据拘巨剧距拒驹惧矩足
橙	呈成惩程城诚承乘盛澄	称秤撑逞
橡	像相项向乡巷象	想祥箱镶厢详享响湘翔香降
橱	锄储除厨雏	矗畜初触楚处础出
檀	弹痰坛昙谈谭潭	贪瘫毯碳叹炭探滩袒坦摊
檬	朦盟萌蒙	梦锰猛孟
欠	歉纤	浅千谴前钱钳干嵌迁潜牵黔签铅谦遣
次	赐伺厕刺	瓷此词差雌祠辞慈磁
欢		唤缓环换幻痪宦焕涣还患
欣	薪新辛心锌芯	衅信寻
欧	区殴呕鸥	藕偶
欲	域裕玉愈尉育誉浴寓芋御狱郁与豫预遇语吁谷喻	逾予雨屿迂于愉渔榆鱼娱舆隅愚羽淤宇
欺	戚漆栖凄溪柒妻七	泣迄畦稽脐只鳍气奇砌契企祈骑枝启旗歧起器乞棋弃汽齐其崎岂期
款		宽
歇	些	骇屉屑鞋挟蟹携谐楔斜邪懈械胁谢写协卸契泻解血
歉	纤欠	浅千谴前钱钳干嵌迁潜牵黔签铅谦遣
歌	搁戈割胳哥鸽疙	阁合格革隔葛蛤各个
止	只址征指纸趾旨	植治致制直脂窒掷氏织帜执稚蜘之志智挚枝肢值职至支秩吱置汁芝知滞殖识质
正	丁政征筝怔证症狰郑睁挣蒸争	拯整
此		瓷厕刺赐词伺差雌祠辞次慈磁
步	埠簿怖部布不	捕补哺卜
武	舞伍捂侮午鹉五	无于务雾巫诬乌吴勿梧呜污芜悟亡屋恶蜈晤误物坞
歧	只鳍枝旗棋畦奇其齐崎脐祈骑期	泣迄戚稽漆妻七气砌契凄企启栖欺柒起器乞弃汽溪岂
歪		外舀
歹	逮	贷戴袋带大待呆代怠
死		寺食司四丝饲伺肆思似斯撕赐嘶私
歼	坚兼尖艰溅煎渐间监肩奸	践建鉴健涧拣捡键检碱贱箭柬简剪荐茧俭舰减见件剑
殃	央鸯秧	阳羊养杨扬痒样氧仰洋漾
殉	逊讯训驯迅汛	巡寻旬勋询循
殊	疏梳枢输书蔬舒抒	术鼠曙束署暑属庶恕漱熟树黍叔薯述蜀赎淑数竖墅
残	蚕惭	惨参餐灿
殖	植值执职直质掷	址治致制脂窒只氏征织帜稚蜘之志智挚枝肢止纸趾至支秩吱置汁芝知滞指识旨
殴	欧区呕鸥	藕偶
段	锻缎断	短端
殷	淹咽因奄烟茵音姻燕厌阴	引炎银艳焰延雁癌砚印听淫衍盐言掩谚吟隐饮颜蚓沿验堰眼唁瘾演宴阎研严
殿	店垫甸玷淀佃奠电惦	颠典点碘
毁	虫贿悔诲会	恢茴堕惠晦讳汇挥回绘辉徽灰慧溃秽蛔
毅	腋邑逸艺肄掖亦意抑义溢疫异役易忆翼衣益亿奕液译绎屹艾一议谊	夷疑医仪伊漪依已以倚椅乙遗移姨胰宜尾揖蛇蚁矣壹
母	亩姥姆拇牡	幕募木慕暮沐目牧墓穆模睦
每	美	媒煤霉枚昧妹梅楣玫媚眉没
毒	牍独读	肚渡堵督杜都睹度镀妒赌
比	庇毙臂毕彼匕弊币必避辟泌壁碧璧闭笔蔽鄙	逼鼻
毕	庇毙臂弊币必避辟泌壁碧璧闭比蔽鄙	逼彼鼻匕笔
毙	庇臂毕弊币必避辟泌壁碧璧闭比蔽鄙	逼彼鼻匕笔
毛	矛锚茅	贸冒猫貌帽茂
毡	沾瞻占	栈暂盏战站蘸崭绽颤斩展
毫	鹤壕号嚎豪	浩镐耗好蒿
毯	袒坦	贪檀碳炭叹探谭潭弹瘫痰坛昙谈滩摊
氏	拭势室使柿侍饰脂誓只恃示织式蜘事之释适嗜枝肢逝是市士支世吱试汁芝视知识	址植提匙施治屎致时制驶拾直窒掷狮实征诗什食帜石执十稚史志射尸智挚失硕值止纸趾职虱至蚀秩置矢滞殖指质旨始师湿
民		敏皿闽悯
氓	芒盲茫忙	莽
气	泣器迄弃砌汽契企妻	戚稽畦漆脐七只鳍奇凄祈骑枝旗启栖欺起歧柒乞棋齐其溪崎岂期
氛	纷吩分芬	粉愤粪奋份忿焚坟
氢	倾卿顷轻清蜻青	亲庆情擎请晴
氧	痒养仰	阳羊鸯杨样扬秧殃央洋漾
氨	安鞍庵	按案暗岸俺
氮	诞弹石担蛋旦但淡	单胆耽丹
氯	露录鹿滤律陆绿虑路率赂碌	侣卢履屡炉旅娄卤芦驴颅鲁铝吕缕庐虏
水		谁睡说税蜕
永	泳蛹踊拥咏勇	庸用佣
汁	只氏芝枝肢知织蜘支之吱脂	址植治致制直窒掷征帜执稚志智挚值止纸趾职至秩置滞殖指识旨质
求	仇球囚	蚯丘龟秋
汇	诲惠讳贿绘晦慧会溃秽	恢虫茴堕回挥辉毁徽悔灰蛔
汉	旱焊悍翰撼憾捍汗	罕韩喊寒和函涵含酣
汗	韩旱悍汉寒函翰撼涵憾捍焊含	罕和酣喊
汛	逊讯训驯迅殉	巡寻旬勋询循
汞	共拱矿巩	弓公攻工哄烘贡轰供红虹宫宏蚣躬鸿恭洪功
江	将浆姜僵疆缰	桨酱蒋强匠讲奖降
池	匙驰迟持弛	翅斥赤吃尺嗤齿耻侈
污	于巫诬屋乌呜恶	无务伍雾午吴舞勿梧五武芜悟亡蜈晤误物坞捂侮鹉
汤	伤商	上躺尚趟唐糖棠膛晌淌赏堂烫裳倘搪塘
汪		往旺网妄忘枉王亡望
汰	态泰太	台抬胎苔
汹	凶匈胸兄	雄熊
汽	泣器迄气弃砌契企妻	戚稽畦漆脐七只鳍奇凄祈骑枝旗启栖欺起歧柒乞棋齐其溪崎岂期
沃	握卧	窝涡我
沈	审婶	甚呻神慎信肾申绅渗深参身伸
沈	臣晨审婶沉尘陈辰忱	称伸甚呻慎趁信肾绅申渗衬深参身神
沉	沈臣晨尘陈辰忱	趁称衬
沐	幕募木慕暮目牧墓穆睦	亩姥姆母拇模牡
沙	砂煞杉纱杀	霎厦傻
沛	配佩	陪培赔坏胚
沟	勾钩句	苟垢购狗构够
没	默漠媒磨墨脉霉莫枚沫梅陌茉眉煤末膜楣玫寞	美么每昧蘑摩抹魔摸媚摹模妹
沥	立吏砾雳丽痢隶粒励厉力荔历莉例俐利栗	李离礼犁厘理哩黎篱狸梨漓璃里鲤
沦	仑轮抡伦论
沧	仓苍舱	藏
沪	户护互	壶许呼狐戏唬乎胡葫虎忽糊蝴弧湖
沫	默漠磨墨脉末莫膜陌寞茉没	么蘑摩魔抹摸摹模
沮	拘蛆居车俱驹矩举锯	鞠聚巨剧距橘具拒惧炬句局据菊足
河	合核盖和荷何禾盒褐	鹤喝吓呵贺赫
沸	废吠费肺	啡肥菲非诽飞匪
油	尤由犹游邮	佑忧幽悠友又诱有幼优右
治	智挚知致滞帜质识稚至制秩置志窒	址植直脂掷只氏征织执蜘之枝肢值止纸趾职支吱汁芝殖指旨
沼	找爪	昭赵罩招嘲召朝兆着照
沽	估辜家咕姑孤	固股凸贾古雇鼓顾告滑故骨谷
沾	毡瞻占	栈暂盏战站蘸崭绽颤斩展
沿	谚咽炎淹焰艳颜延雁验堰癌厌砚唁严阎宴研燕盐言	演奄殷衍烟眼掩
泉	卷拳权犬痊全	劝圈券
泊	渤搏勃伯卜薄破脖膊舶白柏朴博魄驳荸迫	剖剥跛簸颇播拨波般婆坡玻菠泼
泌	庇毙臂毕弊币必避辟密壁碧璧蜜闭觅秘比蔽鄙	咪逼靡弥彼鼻匕米迷谜笔糜
法	阀乏伐发罚筏
泛	饭犯贩范	樊返矾繁烦帆番凡翻反
泞		拧狞能凝柠宁
泡	炮	跑袍咆刨抛
波	泼坡	泊剖朴魄颇破婆迫
泣	器迄气弃砌汽契企妻	戚稽畦漆脐七只鳍奇凄祈骑枝旗启栖欺起歧柒乞棋齐其溪崎岂期
泥	尼呢逆溺匿腻	你拟
注	助住柱祝铸蛀驻	朱贮煮蛛主猪拄筑术珠属轴竹烛逐诸嘱株
泪	累类擂	垒儡勒蕾雷
泰	态汰太	台抬胎苔
泳	蛹踊拥咏勇永	庸用佣
泵	刘流榴硫留瘤琉	铆陆溜柳六馏
泻	骇屉谢屑蟹卸契楔解懈械	鞋写挟协些携谐歇斜邪血胁
泼	波坡	泊剖朴魄颇破婆迫
泽	窄择贼则责	怎侧
洁	节杰竭截捷劫结	接揭皆阶届街界介姊借解诫戒姐芥
洋	杨扬阳羊	鸯养样痒秧殃氧仰央漾
洒	撒	萨飒
洗	徙喜	悉熙厘习畦惜锡戏媳隙牺西希膝息栖吸携晰熄析席夕行系袭昔犀稀溪嬉蟋细
洛	烙落酪络骆	箩萝锣骡裸螺罗逻
洞	栋动冻	懂董东冬
津	金斤巾禁浸今筋襟	进尽锦紧劲仅谨近晋
洪	虹鸿红宏	汞轰哄烘
洲	周州舟粥	昼肘咒皱帚轴宙
活		豁或和获伙货火祸霍惑
洼	挖蛙	娃瓦袜
洽	恰狭匣挟暇峡侠霞斜辖	虾瞎下卡夏吓厦
派	湃	排牌徘拍
流	刘榴硫留瘤泵琉	铆陆溜柳六馏
浅	遣谴	千前钱钳歉干嵌迁欠潜牵纤黔签铅谦
浆	将姜江僵疆缰	桨酱蒋强匠讲奖降
浇	交椒蕉胶焦骄礁教娇郊	矫侥搅狡轿叫觉绞饺角窖剿校脚较嚼缴
浊	卓茁灼拙着啄琢酌	桌捉
测	策册侧厕
济	纪际妓给荠祭脊记季剂几系既计鲫继技忌挤寄己冀骑	叽稽籍即吃棘唧借急嫉迹基集级寂及饥箕奇积畸吉讥激绩辑居机击圾肌其鸡期极疾
浑	魂混	昏荤婚
浓	农脓	弄
浙	这宅蔗	遮摘折哲着者辙
浦	圃普谱	菩瀑仆扑葡朴铺暴蒲脯
浩	镐号耗好	鹤壕毫嚎蒿豪
浪		琅朗廊狼郎榔
浮	俘	孵傅
浴	域裕玉愈尉育誉寓欲芋御狱郁与豫预遇语吁谷喻	逾予雨屿迂于愉渔榆鱼娱舆隅愚羽淤宇
海		骇咳害孩还亥
浸	津金进尽斤劲仅巾禁今近筋晋襟	紧锦谨
涂	凸徒图突屠途	土吐兔秃
消	嚣哮削宵硝箫销萧	孝晓肖校小笑酵效学啸
涉	社赦射舍叶拾摄设	甚舌什奢蛇赊
涎	嫌衔弦舷闲贤咸	仙现馅显掀险陷先腺纤线限铣癣鲜献县宪
涕	惕屉剃替	剔梯提体啼蹄堤题踢
涛	滔萄逃淘陶桃掏	讨套
涡	窝	沃握我卧
涣	唤换幻痪宦焕患	缓环欢还
涤	笛的嘀嫡敌芽	弟抵蒂低递帝滴底第地缔
润	闰
涧	践建溅鉴渐健荐监件键舰间贱剑见箭	坚柬拣捡茧兼简尖检剪俭艰碱减煎歼肩奸
涨	丈掌长帐胀杖仗账障	章张彰樟
涩	塞瑟色圾
涮		栓拴
涯	牙蚜衙押芽	压鸭鸦轧雅呀讶亚哑
液	腋邑逸艺肄掖亦意抑义溢疫异役易忆翼衣益亿奕毅译绎屹艾一议谊	夷疑医仪伊漪依已以倚椅乙遗移姨胰宜尾揖蛇蚁矣壹
涵	韩寒函汗含	罕旱悍喊和翰撼憾捍焊汉酣
淀	店垫殿甸玷佃奠电惦	颠典点碘
淆	侥摇遥肴谣窑姚	么耀夭哟舀腰药乐咬吆要拗钥邀妖
淋	临鳞琳邻林磷	凛赁吝躏
淌	躺倘	堂趟唐糖烫棠膛汤搪塘
淑	赎熟叔	树梳黍术鼠薯曙述蜀束署书抒暑疏殊枢输属数竖庶蔬恕墅漱舒
淘	萄逃陶桃涛	套掏讨滔
淡	弹石氮担蛋旦但诞	单胆耽丹
淤	迂	屿于愈愉榆浴狱渔娱与豫舆隅遇语羽谷喻域逾裕雨予玉尉育誉鱼寓欲愚御郁预吁芋宇
淫	吟银	印瘾隐引听饮因殷蚓茵音姻阴
淮	怀徊槐	坏
深	伸信绅申参身呻	沈甚审慎婶肾渗神
淳	醇唇纯	春蠢
混	浑魂	昏荤婚
淹	谚咽焰艳奄雁验烟沿堰厌唁砚宴殷研燕	严炎演颜阎延衍癌盐言眼掩
添	天	舔恬填甜田
清	氢倾卿顷轻蜻青	亲庆情擎请晴
渊	宛冤鸳	远源猿辕原愿怨援缘园元袁院员圆
渐	践尖建鉴溅歼健荐监坚涧件键兼艰舰奸煎间贱剑肩见箭	柬拣捡茧检简俭剪碱减
渔	逾愉娱鱼榆舆隅愚	屿愈浴淤狱豫遇羽语谷喻域裕予雨尉育誉寓欲御迂郁预吁芋宇
渗	肾慎甚	沈伸呻审婶信申绅深参身神
渠		曲圈屈蛆去漆趋躯取岖娶驱趣区
渡	肚杜度镀妒	牍堵督毒都读睹独赌
渣	眨扎喳查	诈栅炸乍闸
渤	泊舶搏勃白柏伯博卜脖薄驳膊荸	剥跛簸玻播拨般菠
温	瘟	免紊问吻蚊文闻纹稳
港	岗	扛纲冈缸肛钢刚
渴	坷可	咳磕苛科客课蝌棵刻壳颗克
游	尤由犹邮油	佑忧幽悠友又诱有幼优右
渺	秒藐	庙描妙瞄苗
湃	派	排牌徘拍
湖	壶狐胡葫糊蝴弧	许呼沪互戏唬户乎护虎忽
湘	相箱乡镶厢香	像橡项想祥向巷详享响翔象降
湾	豌弯	玩顽万腕碗宛娩丸完惋婉晚挽
湿	狮失施诗虱师尸	拭提匙势室时屎使柿侍驶拾饰誓氏实食恃什示石十式史事射释适嗜硕逝是市士蚀世矢试视识始
溃	诲惠讳贿汇绘愧晦慧会秽	恢虫葵傀茴堕窥回挥魁辉毁徽悔灰盔亏蛔
溅	践尖建鉴歼健渐荐监坚涧件键兼艰舰奸煎间贱剑肩见箭	柬拣捡茧检简俭剪碱减
溉	丐概盖钙	该改
源	猿辕原援园缘元袁员圆	远宛渊愿怨冤鸳院
溜	馏陆六	刘铆流榴硫留瘤柳泵琉
溢	腋邑逸艺肄掖亦意抑义疫异役易忆翼衣益亿奕液毅译绎屹艾一议谊	夷疑医仪伊漪依已以倚椅乙遗移姨胰宜尾揖蛇蚁矣壹
溪	悉膝熙戚厘畦漆栖吸携晰欺柒析妻七行西牺犀凄稀嬉希蟋	泣迄稽习惜脐锡只徙鳍气戏奇砌媳隙喜契企祈骑枝启旗息洗起歧熄席系夕器乞棋袭弃昔汽齐其崎岂期细
溯	缩肃宿粟塑诉素速	酥苏俗
溶	荣绒茸蓉榕熔容融	冗
溺	泥腻匿逆	你拟尼呢
滋	资姿咨吱	自字紫仔籽子滓
滑	豁骨华股凸古划桦鼓贾猾谷哗	估沽辜化花话家画雇咕告顾姑孤故固
滓	仔子籽紫	资滋自字姿吱咨
滔	掏涛	萄逃淘陶讨套桃
滚		棍
滞	智挚知致治帜质识稚至制秩置志窒	址植直脂掷只氏征织执蜘之枝肢值止纸趾职支吱汁芝殖指旨
满		蛮曼瞒幔慢漫馒蔓
滤	氯律绿虑率	侣履屡旅娄驴缕铝吕
滥	缆烂	拦览蓝懒澜榄篮揽栏兰
滨	缤宾彬濒	鬓
滩	贪瘫探摊	弹檀毯痰坛碳叹昙炭谈袒谭坦潭
滴	低	抵嘀蒂嫡帝芽缔笛的弟递底第涤敌地
漂	飘票	瓢
漆	戚去栖凄溪娶欺趣柒妻七	泣迄蛆稽畦取驱脐只鳍气奇砌契岖企祈骑曲枝屈启旗起歧区圈器乞棋弃趋躯汽齐其崎岂期渠
漏	露陋	篓搂楼娄
漓	离犁厘黎篱狸梨丽璃	李理隶沥礼励历莉吏立砾雳痢粒厉哩力荔例俐利里鲤栗
演	眼掩衍	谚咽炎淹焰艳颜奄延雁烟验沿堰癌厌砚唁严阎殷宴研燕盐言
漠	默磨墨脉末沫莫膜陌寞茉没	么蘑摩魔抹摸摹模
漩	炫玄悬旋县	喧宣轩选
漪	揖衣医伊一依壹	夷疑艺肄意抑仪疫异忆翼益奕液毅屹艾已议以倚谊腋邑逸掖椅乙亦义溢遗移役易姨胰宜尾亿译绎蛇蚁矣
漫	蛮曼瞒幔慢馒蔓	满
漱	树疏术数述竖庶束署曙恕墅	暑梳殊枢黍输鼠薯叔属蜀淑书蔬舒赎熟抒
漾	样养	阳羊鸯杨扬痒秧殃氧仰央洋
潘	攀	胖叛判般盘畔盼
潜	干黔前钱钳	嵌浅千迁欠牵纤签谴铅谦遣歉
潦	聊撩疗缭辽寥燎僚嘹	了料
潭	弹檀痰坛昙谈谭	贪瘫毯碳叹炭探滩袒坦摊
潮	朝嘲巢	吵抄钞超炒剿
澄	呈成惩程城诚承乘盛橙	称秤撑逞
澈	撤辙彻	车扯
澎	棚膨砰硼鹏篷烹蓬朋彭	捧碰
澜	拦蓝篮栏兰	览懒榄缆烂揽滥
澡	蚤藻早枣	皂躁造糟灶噪遭燥凿
澳	懊傲奥拗	袄熬凹
激	绩叽稽居唧机几迹基饥箕奇肌其积畸鸡期讥	纪妓即给籍荠吃棘脊借急记嫉既鲫级集寂及继济挤寄冀吉骑际辑祭季剂击系计技忌圾己极疾
濒	缤彬贫宾频滨	鬓拼品聘
瀑	暴铺	脯菩仆葡朴浦谱蒲圃普扑
灌	观惯冠贯罐	馆管官棺关
火	伙	豁或和获货活祸霍惑
灭	蔑
灯	登	凳等瞪邓蹬
灰	恢堕挥辉徽	虫茴惠晦讳贿汇回绘毁悔诲慧会溃秽蛔
灵	凌菱玲伶蛉铃陵龄翎零	岭另领令
灶	皂躁造噪燥	蚤糟早枣遭藻凿澡
灸	九酒久韭纠玖	就舅揪鸠臼旧救疚究
灼	卓浊茁拙着啄琢酌	桌捉
灾	栽	仔宰在再载
灿		惨惭残餐蚕参
炉	芦卢庐颅	露录鹿氯卤陆路鲁虏赂碌
炊	吹	椎垂捶锤
炎	颜阎延沿研癌盐言严	淹谚咽唁演艳焰掩奄宴雁烟验殷衍燕堰眼厌砚
炒	吵	嘲潮抄朝钞超巢剿
炕	抗	糠慷扛康
炫	旋漩	喧选轩玄悬宣还县
炬	聚巨剧距具拒俱惧句锯据足	拘鞠蛆沮居车橘驹矩举局菊
炭	碳探叹	贪檀毯袒谭坦潭弹瘫痰坛昙谈滩摊
炮	刨咆泡袍	跑抛
炸	栅诈乍扎闸	眨渣喳查
点	碘典	店垫殿甸玷佃淀奠颠电惦
炼	恋敛练链	帘怜连脸镰莲联廉
烁	蟀硕帅数率勺	说
烂	缆滥	拦览蓝懒澜榄篮揽栏兰
烈	列劣猎裂	咧
烘	轰哄	虹宏汞鸿洪红
烙	劳洛落酪络骆	箩萝锣骡牢裸姥老螺罗捞唠逻
烛	术筑轴竹逐	助朱贮煮住注猪主珠柱蛛祝属铸拄蛀诸嘱驻株
烟	淹咽奄殷燕厌	炎艳焰延雁癌砚衍盐言掩谚颜验沿堰眼唁演阎宴研严
烤	考拷	铐靠
烦	樊帆繁凡矾	返范犯泛番饭翻反贩
烧	稍梢捎	芍少勺绍召哨
烫	趟	淌躺堂唐糖棠膛倘汤搪塘
热		惹若
烹	澎砰	棚膨碰硼鹏捧篷蓬朋彭
焊	旱悍翰撼憾捍汗汉	罕韩喊寒和函涵含酣
焕	唤换幻痪宦涣患	缓环欢还
焙	臂背贝被辈狈惫备倍	卑悲杯北碑
焚	坟	粉愤芬粪奋分份忿吩纷氛
焦	交椒蕉娇胶礁教骄浇郊	矫侥搅狡轿叫觉绞饺角窖剿校脚较嚼缴
焰	谚咽淹艳宴雁沿验研燕堰砚厌唁	严炎演颜奄延烟阎殷衍癌盐言眼掩
然	燃	染
煌	黄皇凰惶蝗	恍谎荒慌晃幌
煎	坚兼尖艰溅歼渐间监肩奸	践建鉴健涧拣捡键检碱贱箭柬简剪荐茧俭舰减见件剑
煞	霎沙砂杉纱厦杀	傻
煤	媒霉枚梅楣玫眉没	美每昧媚妹
照	兆赵罩召	昭嘲找招爪朝着沼
煮	贮嘱主属拄	助朱住注蛛猪柱筑术珠祝铸轴竹烛蛀诸逐驻株
熄	习袭息媳昔惜席锡	悉熙厘畦徙戏隙西喜牺希膝栖吸洗携晰析系行夕犀稀溪嬉蟋细
熊	雄	匈凶胸汹兄
熔	溶荣绒茸蓉榕容融	冗
熙	悉膝厘畦栖吸携晰析行西牺犀稀嬉希溪蟋	徙习戏息系袭细隙媳喜惜洗昔熄席锡夕
熟	淑赎叔	售术鼠曙束署书暑属守兽庶手恕漱舒树收梳黍首薯述瘦蜀受寿抒疏殊枢输数竖授蔬墅
熬		澳袄懊拗傲奥凹
燃	然	染
燎	撩聊料疗了缭辽寥潦僚嘹
燕	谚咽淹焰艳奄雁验烟沿堰厌唁砚宴殷研	严炎演颜阎延衍癌盐言眼掩
燥	皂躁造灶噪	蚤糟早枣遭藻凿澡
爆	暴刨豹抱报	褒堡饱包薄雹苞保宝胞
爪	沼找	昭赵罩招嘲抓召朝兆着照
爬	耙扒	趴帕怕
爱	碍艾隘	哀蔼挨哎埃矮唉
爵	掘倔决觉角诀绝脚嚼
父	妇赴傅咐腹抚俯府辅付附脯赋富复斧负甫腐副	芙敷辐蝠浮福幅服缚俘肤孵符袱扶麸伏拂夫
爷	椰	页咽野夜业叶也冶射谒
爸	霸伯罢耙坝	八靶巴跋扒捌把笆芭拔疤吧叭
爹		碟谍跌蝶叠
爽		双霜
片	遍骗	偏便篇翩扁
版	板	拌扮半伴班扳搬颁绊办瓣般斑
牌	排徘	拍湃派
牍	毒独读	肚渡堵督杜都睹度镀妒赌
牙	蚜涯衙押芽	压鸭鸦轧雅呀讶亚哑
牛		钮纽扭拗
牡	亩姥姆母拇	幕募木慕暮沐目牧墓穆模睦
牢	劳唠	烙姥老酪捞络
牧	幕募木慕暮沐目墓穆睦	亩姥姆母拇模牡
物	勿务晤雾误坞悟恶	无于伍巫诬午乌吴舞梧武五呜污芜亡屋蜈捂侮鹉
牲	生升胜笙甥声	乘绳剩圣盛省
牵	嵌千迁纤签铅谦	干浅潜欠黔谴前钱钳遣歉
牺	悉膝熙厘畦栖吸携晰析行西犀稀嬉希溪蟋	徙习戏息系袭细隙媳喜惜洗昔熄席锡夕
犀	悉膝熙厘畦栖吸携晰析行西牺稀嬉希溪蟋	徙习戏息系袭细隙媳喜惜洗昔熄席锡夕
犁	离厘黎篱狸梨漓丽璃	李理隶沥礼励历莉吏立砾雳痢粒厉哩力荔例俐利里鲤栗
犬	泉卷拳权痊全	劝圈券
犯	饭贩泛范	樊返矾繁烦帆番凡翻反
状	壮撞	妆装庄桩
犹	尤由游邮油	佑忧幽悠友又诱有幼优右
狂		框筐旷眶况矿
狈	臂背贝被辈焙惫备倍	卑悲杯北碑
狐	壶胡葫糊蝴弧湖	许呼沪互戏唬户乎护虎忽
狗	苟	勾钩沟垢购构句够
狞	拧凝柠宁	泞
狠	很	痕恨
狡	侥较搅矫绞饺角剿脚缴	交椒轿叫觉蕉娇胶焦窖礁教校骄浇郊嚼
独	牍毒读	肚渡堵督杜都睹度镀妒赌
狭	匣洽挟暇峡侠霞斜辖	虾厦瞎下吓夏
狮	失施诗虱师湿尸	拭提匙势室时屎使柿侍驶拾饰誓氏实食恃什示石十式史事射释适嗜硕逝是市士蚀世矢试视识始
狰	丁正征筝怔症睁挣蒸争	政整郑证拯
狱	域裕玉愈尉育誉浴寓欲芋御郁与豫预遇语吁谷喻	逾予雨屿迂于愉渔榆鱼娱舆隅愚羽淤宇
狸	离犁厘黎篱漓梨丽璃	李理隶沥礼励历莉吏立砾雳痢粒厉哩力荔例俐利里鲤栗
狼	琅郎榔廊	浪朗
猎	列劣烈裂	咧
猖	倡昌	场唱长偿厂畅常尝肠裳敞
猛	锰	蒙萌梦孟檬朦盟
猜		菜财采材踩才裁彩睬
猩	腥星兴	邢行型刑形醒性姓杏幸省
猪	朱蛛珠诸株	助贮煮住注主柱筑术祝属铸轴拄竹烛蛀嘱驻逐
猫		贸冒毛茅矛锚貌帽茂
献	现馅陷腺线限县宪	仙嫌显衔闲弦险掀先纤涎舷癣鲜铣贤咸
猴	侯喉	候吼厚后
猾	豁划桦滑华哗	化花话画
猿	源辕原援缘园元袁员圆	远宛渊愿怨冤鸳院
玄	漩悬旋还县	喧选炫轩宣
率	蟀硕帅氯滤律烁绿虑数勺	侣甩履屡旅娄衰说驴缕铝吕摔
玉	域裕尉愈育誉浴寓欲芋御狱郁与豫预遇语吁谷喻	逾予雨屿迂愉榆鱼娱舆隅愚羽淤宇
王	旺忘妄亡望	往汪网枉
玖	九酒久韭灸纠	就舅揪鸠臼旧救疚究
玛	码蚂吗马	么蟆麻妈骂
玩	顽万腕丸完惋	娩碗宛豌湾婉晚弯挽
玫	媒煤霉枚梅楣眉没	美每昧媚妹
环	还	唤缓换幻痪宦焕涣欢患
现	馅陷腺线限献县宪	仙嫌显衔闲弦险掀先纤涎舷癣鲜铣贤咸
玲	凌灵菱伶蛉铃陵龄翎零	岭另领令
玷	店垫殿甸淀佃奠电惦	颠典点碘
玻	剥播拨般菠	泊舶渤搏勃驳白柏伯跛博卜簸薄脖膊荸
珊	衫山杉删扇	闪陕善单赡擅膳
珍	诊侦榛斟针贞真	阵振枕震疹镇
珠	朱蛛猪诸株	助贮煮住注主柱筑术祝属铸轴拄竹烛蛀嘱驻逐
班	扳搬颁般斑	拌扮半伴板版绊办瓣
球	求仇囚	蚯丘龟秋
琅	狼郎榔廊	浪朗
理	李礼哩里鲤	立吏犁厘黎狸梨砾雳丽痢璃隶沥离粒励厉力荔历莉篱漓例俐利栗
琉	刘流榴硫留瘤泵	铆陆溜柳六馏
琐	锁索所	缩唆嗦梭
琢	卓浊茁灼拙着啄酌	桌捉
琳	临淋鳞邻林磷	凛赁吝躏
琴	勤擒秦禽芹	侵亲钦寝
琼	穷
瑞	锐	蕊
瑟	塞色圾涩
瑰	傀归规龟闺	跪鬼诡桂柜贵轨
璃	离犁厘黎篱狸梨漓丽	李理隶沥礼励历莉吏立砾雳痢粒厉哩力荔例俐利里鲤栗
璧	庇毙臂毕弊币必避辟泌壁碧闭比蔽鄙	逼彼鼻匕笔
瓜	蜗括刮	卦挂寡褂
瓢		漂飘票
瓣	拌扮半伴绊办	班板扳搬颁版般斑
瓤	攘	让壤嚷
瓦		袜洼蛙娃挖
瓶	苹萍平评屏坪冯凭	乒
瓷	词雌祠辞慈磁	厕刺此伺差赐次
甘	干肝竿杆柑	感赶敢秆橄
甚	舌什慎肾蛇渗神	婶拾涉奢赦射身呻信绅舍叶赊摄参设社沈审申深伸
甜	填恬田	添天舔
生	牲升胜笙甥身声	乘绳剩圣盛省
甥	生牲升胜笙声	乘绳剩圣盛省
用	佣	泳蛹踊拥咏勇庸永
甩		蟀帅率摔衰
甫	腐斧父抚俯府辅脯	妇赴辐浮缚腹符麸伏拂付附赋福俘负袱夫芙敷傅蝠咐肤富复幅服孵扶副
田	填恬甜	添天舔
由	尤犹游邮油	佑忧幽悠友又诱有幼优右
甲	钾贾夏假	佳荚加挟价家茄稼颊嫁夹架嘉驾
申	伸信绅深参身呻	沈甚审慎婶肾渗神
电	店垫殿甸玷淀佃奠惦	颠典点碘
男	难南
甸	店垫殿玷淀佃奠电惦	颠典点碘
画	化划桦话华	豁花滑猾哗
畅	唱倡	场长昌偿厂常尝肠裳敞猖
界	届介借解诫戒芥	接节杰竭截揭阶皆街劫捷姊结洁姐
畏	为卫谓位尉喂伪胃未味遗慰蔚魏	委伟尾薇苇违维围威偎萎纬唯危微巍桅
畔	叛判盼	胖潘攀般盘
留	刘流榴硫瘤泵琉	铆陆溜柳六馏
畜	矗叙绪触恤酗处序絮旭婿蓄续	许锄储徐初吁需楚橱除虚础厨雏出须
略	掠
畦	悉熙厘脐只鳍奇西牺希祈骑膝枝旗栖吸携晰歧析行棋犀齐其稀嬉溪蟋崎期	泣迄戚习漆稽惜妻七锡徙气戏砌媳隙喜契凄企启息洗欺起柒熄席夕系器乞袭弃昔汽岂细
番	翻帆	樊反返范犯烦繁饭凡泛矾贩
畴	稠绸筹愁仇酬	臭抽丑
畸	激绩叽稽居唧机几迹基饥箕奇肌其积鸡期讥	纪妓即给籍荠吃棘脊借急记嫉既鲫级集寂及继济挤寄冀吉骑际辑祭季剂击系计技忌圾己极疾
疆	将浆姜江僵缰	桨酱蒋强匠讲奖降
疏	树梳术曙述束署书抒殊枢输数竖庶蔬恕墅漱舒	暑黍鼠薯叔属蜀淑赎熟
疑	夷宜蛇遗仪一移姨胰谊	医艺肄意抑伊疫异漪忆翼衣益奕液毅屹艾依已议以倚腋邑逸掖椅乙亦义溢役易揖尾亿译绎蚁矣壹
疗	聊撩缭辽寥潦燎僚嘹	了料
疙	搁戈割胳哥鸽歌	阁合格革隔葛蛤各个
疚	就舅臼救旧究	九酒久揪鸠韭灸纠玖
疟	虐
疤	八巴扒捌笆芭吧叭	爸靶霸把伯耙罢拔跋坝
疫	腋邑逸艺肄掖亦意抑义溢役异易忆翼衣益亿奕液毅译绎屹艾一议谊	夷疑医仪伊漪依已以倚椅乙遗移姨胰宜尾揖蛇蚁矣壹
疮	窗囱创	抢幢闯床撞
疯	丰峰风封枫锋讽蜂	奉凤缝逢冯
疲	皮脾罢啤	屁否匹霹批坏被譬僻劈披辟
疹	诊枕	阵振震侦珍斟榛针贞镇真
疼	誊腾
疾	辑即籍吃棘脊唧借急嫉击级集寂及圾吉极	纪叽妓稽给荠记几迹既鲫基饥箕继奇济挤积寄畸冀骑讥际激绩居祭机季剂系计技忌肌其己鸡期
病	并	饼柄禀冰兵秉屏丙
症	丁正征筝怔狰睁挣蒸争	政整郑证拯
症	政正郑证挣	丁征整睁拯狰筝怔蒸争
痊	泉卷拳权犬全	劝圈券
痒	养氧仰	阳羊鸯杨样扬秧殃央洋漾
痕		很恨狠
痘	斗豆读逗	都陡兜蚪抖
痛		统彤桐同铜桶筒童通瞳
痢	立吏砾雳丽隶沥粒励厉力荔历莉例俐利栗	李离礼犁厘理哩黎篱狸梨漓璃里鲤
痪	唤换幻宦焕涣患	缓环欢还
痰	弹檀坛昙谈谭潭	贪瘫毯碳叹炭探滩袒坦摊
瘟	温	免紊问吻蚊文闻纹稳
瘤	刘流榴硫留泵琉	铆陆溜柳六馏
瘦	售兽授受寿	收首守手熟
瘩	搭答达	大打
瘪		别鳖
瘫	贪探摊滩	弹檀毯痰坛碳叹昙炭谈袒谭坦潭
瘸		怯鹊却确缺雀壳
瘾	隐引听饮蚓	印吟淫银因殷茵音姻阴
癌	炎颜阎延沿研盐言严	淹谚咽唁演艳焰掩奄宴雁烟验殷衍燕堰眼厌砚
癞	赖	莱来
癣	险显铣鲜	仙嫌馅衔弦先腺线涎舷闲贤县咸现掀陷纤限献宪
登	灯	凳等瞪邓蹬
白	泊舶渤搏勃柏伯博卜脖薄驳膊荸	败剥跛簸百玻播拨摆般拜菠
百	摆	白拜败
皂	躁造灶噪燥	蚤糟早枣遭藻凿澡
的	笛弟嘀蒂得递嫡帝第涤敌芽地缔	抵德低滴底
皆	接揭阶街结	节杰竭截届界介劫捷借解诫戒姊姐洁芥
皇	黄煌凰惶蝗	恍谎荒慌晃幌
皮	脾疲罢啤	屁否匹霹批坏被譬僻劈披辟
皱	咒昼宙	肘舟周州粥洲轴帚
皿	敏闽悯	民
盅	中忠衷终钟	种肿众重仲
盆		喷
盈	荧营迎蝇赢萤莹	影莺鹦婴英应映缨樱景颖硬鹰
益	腋邑逸艺肄掖亦意抑义溢疫异役易忆翼衣亿奕液毅译绎屹艾一议谊	夷疑医仪伊漪依已以倚椅乙遗移姨胰宜尾揖蛇蚁矣壹
盏	崭斩展	栈暂毡战占沾站瞻蘸绽颤
盐	炎颜阎延沿研癌言严	淹谚咽唁演艳焰掩奄宴雁烟验殷衍燕堰眼厌砚
监	践尖建鉴溅歼健渐荐坚涧件键兼艰舰奸煎间贱剑肩见箭	柬拣捡茧检简俭剪碱减
盒	合核盖和荷何河禾褐	鹤喝吓呵贺赫
盔	窥亏	傀葵魁愧溃
盖	合概丐核溉荷和钙何河禾盒褐	鹤喝该改吓呵贺赫
盗	道悼到稻倒导蹈	叨刀岛祷捣
盘	般胖	潘叛判攀畔盼
盛	呈惩成城程诚承乘剩圣胜橙澄	称秤牲生绳升撑逞笙省甥声
盟	朦萌檬蒙	梦锰猛孟
目	幕募木慕暮沐牧墓穆睦	亩姥姆母拇模牡
盯	丁叮钉	锭鼎定顶订
盲	芒氓茫忙	莽
直	植值殖执职质掷	址治致制脂窒只氏征织帜稚蜘之志智挚枝肢止纸趾至支秩吱置汁芝知滞指识旨
相	像橡项向箱乡镶巷厢湘象香	想祥详享响翔降
盹	囤吨盾顿钝	墩蹲敦
盼	叛判畔	胖潘攀般盘
盾	吮囤吨盹顿钝	敦墩瞬顺蹲
省	醒	邢生刑牲腥星剩姓猩幸盛形甥行型乘绳性升圣胜笙杏声
眉	媒煤霉枚梅玫楣没	美每昧媚妹
看	刊堪勘	砍坎
真	诊侦珍斟榛针贞	阵振枕震疹镇
眠	绵棉	免冕娩勉面缅
眨	渣	诈栅炸乍喳查闸
眶	框旷矿况	筐狂
眷	倦圈卷绢	鹃捐身
眼	掩演衍	谚咽炎淹焰艳颜奄延雁烟验沿堰癌厌砚唁严阎殷宴研燕盐言
着	卓昭嘲浊遮招朝茁灼拙酌啄琢召	桌赵罩宅找爪摘折兆哲浙这蔗者沼辙照捉
睁	丁正征怔症狰筝挣蒸争	政整郑证拯
睛	鲸兢惊精经荆茎京更晶	颈径境竞静阱景净井劲靖警敬竟镜
睡	说税蜕	谁水
督	都	牍肚渡堵毒杜读睹度镀妒独赌
睦	幕募木慕暮沐目牧墓穆	亩姥姆母拇模牡
睬	采踩彩	菜财材猜才裁
睹	赌堵肚	牍渡督毒杜都读镀度妒独
瞄	描苗	庙秒妙渺藐
瞎	虾	狭匣洽厦挟暇峡侠下夏吓霞斜辖
瞒	漫蛮馒	满曼幔慢蔓
瞧	桥侨憔乔翘	巧窍峭锹跷撬壳俏鹊敲悄雀
瞪	凳蹬邓	等登灯
瞬	顺	吮盾
瞳	彤同铜桐童	统筒桶痛通
瞻	沾毡占	栈暂盏战站蘸崭绽颤斩展
矗	处畜触	锄储初楚橱除础厨雏出
矛	锚毛茅	贸冒猫貌帽茂
矢	屎使史驶始	拭提匙势室施时柿侍拾饰誓狮氏实诗恃什示石食十式事射释嗜适尸失逝硕是虱士蚀市世试视识师湿
矣	尾椅乙蚁已以倚	夷疑医艺肄意抑仪伊疫异漪忆翼衣益奕液毅屹艾一依议谊腋邑逸掖亦义溢遗移役易姨胰宜揖亿译绎蛇壹
知	智挚枝肢致治制至支秩吱置脂窒汁芝氏织帜滞识稚蜘之质志	址植征殖止指纸执趾职旨直掷
矩	举沮	聚蛆居车具俱炬句锯局据菊拘鞠巨剧距橘拒驹惧足
矫	侥较搅狡绞饺角剿脚缴	交椒轿叫觉蕉娇胶焦窖礁教校骄浇郊嚼
短		段缎断锻端
矮	蔼	哀碍爱哎埃艾隘挨唉
石	提硕时氮蚀担蛋拾弹实食什淡十射旦但诞	拭匙势室施屎使柿侍驶饰丹誓狮氏诗恃示胆式史耽事释嗜适尸失逝是虱士市世矢试视单识始师湿
矾	樊繁烦帆凡	返范犯泛番饭翻反贩
矿	共汞拱框巩旷眶况	宫红弓筐攻公工狂蚣躬贡恭功供
码	玛蚂吗马	么蟆麻妈骂
砂	沙煞杉纱杀	霎厦傻
砌	泣器迄气弃汽契企妻	戚稽畦漆脐七只鳍奇凄祈骑枝旗启栖欺起歧柒乞棋齐其溪崎岂期
砍	坎	刊勘堪看
研	谚咽炎淹焰艳颜延雁验沿堰癌厌砚唁严阎宴燕盐言	演奄殷衍烟眼掩
砖	专	传撰赚转
砚	谚咽淹焰艳宴雁沿验研燕堰厌唁	严炎演颜奄延烟阎殷衍癌盐言眼掩
砰	烹澎	棚膨碰硼鹏捧篷蓬朋彭
破	泊迫朴魄	剖波颇坡婆泼
砸	杂咱
砾	立吏雳丽痢隶沥粒励厉力荔历莉例俐利栗	李离礼犁厘理哩黎篱狸梨漓璃里鲤
础	储楚处	矗锄畜初触橱除厨雏出
硕	蟀提时蚀拾勺帅实食什石烁十数率射	拭匙势室施屎使柿侍说驶饰誓狮氏诗恃示式史事释适嗜尸失逝是虱士市世矢试视识始师湿
硝	嚣哮削宵箫销萧消	孝晓肖校小笑酵效学啸
硫	刘流榴留瘤泵琉	铆陆溜柳六馏
硬	映应	鹦婴蝇缨赢萤荧莺影营迎莹英樱景颖盈鹰
确	壳鹊怯雀却	瘸缺
硼	棚膨鹏篷澎蓬朋彭	捧碰烹砰
碉	雕刁叼	钓掉吊调
碌	露录鹿氯陆路赂	卢炉卤芦颅鲁庐虏
碍	隘爱艾	哀蔼挨哎埃矮唉
碎	祟穗岁隧遂	随髓虽
碑	悲杯背卑	臂贝被辈焙狈惫北备倍
碗	宛娩婉晚挽	玩顽万腕丸豌完惋湾弯
碘	典点	店垫殿甸玷佃淀奠颠电惦
碟	跌谍蝶叠	爹
碧	庇毙臂毕弊币必避辟泌壁璧闭比蔽鄙	逼彼鼻匕笔
碰		棚膨砰硼鹏捧篷烹朋蓬澎彭
碱	柬拣捡茧检简俭剪减	践尖建鉴歼健监涧键兼贱肩箭溅渐荐坚艰舰煎间件剑见奸
碳	探叹炭	贪檀毯袒谭坦潭弹瘫痰坛昙谈滩摊
碾	撵捻	年念
磁	瓷词雌祠辞慈	厕刺此伺差赐次
磅	傍蚌谤旁棒乓	梆胖膀帮榜螃庞邦绑
磕	苛科蝌棵刻颗	咳坷客课壳渴可克
磨	默漠墨脉莫沫陌魔茉末蘑膜摩寞摹模没	抹摸么
磷	临淋鳞琳邻林	凛赁吝躏
礁	交椒蕉胶焦骄教娇浇郊	矫侥搅狡轿叫觉绞饺角窖剿校脚较嚼缴
示	拭势逝室是使柿侍市士世饰适誓试氏视恃式识事释嗜	提匙施时屎驶拾狮实诗食什石十史射尸失硕虱蚀矢始师湿
礼	李理哩里鲤	立吏犁厘黎狸梨砾雳丽痢璃隶沥离粒励厉力荔历莉篱漓例俐利栗
社	赦射舍叶拾涉摄设	甚舌什奢蛇赊
祈	只鳍枝旗棋畦奇齐其崎脐歧骑期	泣迄戚稽漆妻七气砌契凄企启栖欺柒起器乞弃汽溪岂
祖	组阻诅	卒族租足
祝	助住注柱铸蛀驻	朱贮煮蛛主猪拄筑术珠属轴竹烛逐诸嘱株
神	甚	沈呻审婶慎信肾申绅渗深参身伸
祟	穗岁碎隧遂	随髓虽
祠	瓷词雌辞慈磁	厕刺此伺差赐次
祥	翔详降	像想向箱镶巷湘象橡相项乡厢享响香
票	漂	飘瓢
祭	纪际妓荠寨记季剂系既计鲫债继济技忌寄责冀骑	叽稽给籍即吃棘脊唧借急几嫉迹窄基集级寂饥及箕奇挤积畸吉讥激斋绩宅辑居摘机击圾肌齐其己鸡期极疾
祷	导倒岛捣	道叨悼到稻盗刀蹈
祸	豁或获货霍惑	活和伙火
禀	饼柄秉屏丙	冰兵病并
禁	津金进尽斤劲仅巾今浸近筋晋襟	紧锦谨
福	芙辐蝠浮幅服缚俘袱符扶伏拂夫	妇赴腹麸付脯附赋斧父负甫敷傅咐肤抚俯府辅富复孵腐副
离	犁厘黎篱狸梨漓丽璃	李理隶沥礼励历莉吏立砾雳痢粒厉哩力荔例俐利里鲤栗
禽	勤擒秦琴芹	侵亲钦寝
禾	合核盖和荷何河盒褐	鹤喝吓呵贺赫
秀	锈臭宿袖嗅绣	朽休修羞
私	司丝思斯撕嘶	死食四饲伺肆似赐寺
秃		土凸吐徒兔涂图突屠途
秆	感赶敢杆橄	干肝竿甘柑
秉	饼柄禀屏丙	冰兵病并
秋	蚯丘龟	求仇球囚
种	中肿众重仲	忠盅衷终钟
科	磕苛蝌棵刻颗	咳坷客课壳渴可克
秒	渺藐	庙描妙瞄苗
秘	密蜜觅泌	咪靡弥米迷谜糜
租		祖卒组族阻诅足
秤	称	呈惩成城程诚承乘撑逞盛橙澄
秦	勤擒琴禽芹	侵亲钦寝
秧	央鸯殃	阳羊养杨扬痒样氧仰洋漾
秩	智挚知致治滞帜质识稚至制置志窒	址植直脂掷只氏征织执蜘之枝肢值止纸趾职支吱汁芝殖指旨
积	激绩叽稽居唧机几迹基饥箕奇肌其畸鸡期讥	纪妓即给籍荠吃棘脊借急记嫉既鲫级集寂及继济挤寄冀吉骑际辑祭季剂击系计技忌圾己极疾
称	衬趁秤撑	呈诚承逞辰盛橙忱澄城惩沈程成臣晨乘沉尘陈
移	夷宜疑蛇遗仪一姨胰谊	医艺肄意抑伊疫异漪忆翼衣益奕液毅屹艾依已议以倚腋邑逸掖椅乙亦义溢役易揖尾亿译绎蚁矣壹
秽	诲惠讳贿汇绘晦慧溃会	恢虫茴堕回挥辉毁徽悔灰蛔
稀	悉膝熙厘畦栖吸携晰析行西牺犀嬉希溪蟋	徙习戏息系袭细隙媳喜惜洗昔熄席锡夕
程	呈成惩城诚承乘盛橙澄	称秤撑逞
稍	烧梢捎	芍少勺绍召哨
税	睡说蜕	谁水
稚	智挚知致治滞帜质识制至秩置志窒	址植直脂掷只氏征织执蜘之枝肢值止纸趾职支吱汁芝殖指旨
稠	绸畴筹愁仇酬	臭抽丑
稳	吻	免紊问瘟蚊文闻纹温
稻	道悼到盗倒导蹈	叨刀岛祷捣
稼	假价嫁贾架驾	佳荚钾挟加家甲颊夏夹嘉茄
稽	激绩叽启居唧机起几迹基饥箕乞奇肌积其畸岂鸡期讥	纪泣迄妓戚漆籍给荠畦即吃棘脊借脐记急妻嫉七只既鲫级寂气鳍集及继砌济契挤寄凄企祈冀吉骑际枝旗辑栖祭欺季歧剂柒击系计器棋弃技圾汽忌齐溪崎己极疾
稿	搅搞	高糕羔篙告膏
穆	幕募慕木暮沐目牧墓睦	亩姥姆母拇模牡
穗	祟岁碎隧遂	随髓虽
穴	学血雪削	靴薛
究	就舅臼旧救疚	九酒久揪鸠韭灸纠玖
穷	琼
空	控	恐孔
穿	川	传喘船串
突	凸徒涂图屠途	土吐兔秃
窃	怯切契	且茄
窄	择泽贼则责	侧斋宅债摘怎齐祭寨
窍	峭跷撬壳翘俏	巧桥侨锹瞧憔乔鹊敲悄雀
窑	侥摇淆遥肴谣姚	么耀夭哟舀腰药乐咬吆要拗钥邀妖
窒	智挚知致治滞帜质识稚至制秩置志	址植直脂掷只氏征织执蜘之枝肢值止纸趾职支吱汁芝殖指旨
窖	轿觉叫教校较	椒角胶娇脚嚼矫侥狡绞蕉焦郊搅交饺剿礁骄浇缴
窗	疮囱创	抢幢闯床撞
窘		菌君骏钧峻均龟军竣俊
窜	篡
窝	涡	沃握我卧
窟	枯哭	酷裤库苦
窥	盔亏	傀葵魁愧溃
窿	咙龙隆胧笼聋	拢垄
立	吏砾雳丽痢隶沥粒励厉力荔历莉例俐利栗	李离礼犁厘理哩黎篱狸梨漓璃里鲤
竖	树疏术数述曙庶束署恕墅漱	暑梳殊枢黍输鼠薯叔属蜀淑书蔬舒赎熟抒
站	栈暂战占蘸绽颤	盏沾瞻崭毡斩展
竞	径境静净劲敬靖竟镜	颈兢惊鲸经精睛阱荆茎井警京更景晶
竟	径境竞静净劲敬靖镜	颈兢惊鲸经精睛阱荆茎井警京更景晶
章	张彰樟	丈涨掌长帐胀杖仗账障
竣	骏俊峻菌	窘君钧均龟军
童	彤桐铜同瞳	统筒桶痛通
竭	节杰截劫捷结洁	接揭皆阶届街界介姊借解诫戒姐芥
端		短段缎断锻
竹	术筑轴烛逐	助朱贮煮住注猪主珠柱蛛祝属铸拄蛀诸嘱驻株
竿	干肝杆甘柑	感赶敢秆橄
笆	八巴扒捌芭疤吧叭	爸靶霸把伯耙罢拔跋坝
笋	损	孙
笑	效孝肖酵校啸	嚣晓哮削宵小硝箫销萧学消
笔	匕彼比鄙	逼庇壁毙碧璧臂毕闭鼻弊币必避蔽泌辟
笙	生牲升胜甥声	乘绳剩圣盛省
笛	的嘀嫡涤敌芽	弟抵蒂低递帝滴底第地缔
符	芙辐蝠浮福幅服缚俘袱扶伏拂夫	妇赴腹麸付脯附赋斧父负甫敷傅咐肤抚俯府辅富复孵腐副
笨		本奔
第	的弟蒂递帝地缔	笛抵嘀低嫡滴底涤敌芽
笼	咙龙隆胧窿聋	拢垄
等		凳蹬瞪登灯邓
筋	津金斤巾禁浸今襟	进尽锦紧劲仅谨近晋
筏	阀乏伐法罚	发
筐	框	况狂旷眶矿
筑	术轴竹烛逐	助朱贮煮住注猪主珠柱蛛祝属铸拄蛀诸嘱驻株
筒	桶统	彤桐铜痛同童通瞳
答	搭达瘩	大打
策	侧册测厕
筛		晒杀
筝	丁正征怔症狰睁挣蒸争	政整郑证拯
筷	刽会块快
筹	稠绸畴愁仇酬	臭抽丑
签	嵌千迁牵纤谦铅	干浅潜欠黔谴前钱钳遣歉
简	柬拣捡茧检俭剪减碱	践尖建鉴歼健监涧键兼贱肩箭溅渐荐坚艰舰煎间件剑见奸
箕	激绩叽稽居唧机几迹基饥奇肌其积畸鸡期讥	纪妓即给籍荠吃棘脊借急记嫉既鲫级集寂及继济挤寄冀吉骑际辑祭季剂击系计技忌圾己极疾
算	蒜	酸
管	馆	观惯官棺冠贯罐灌关
箩	萝锣骡螺罗逻	烙裸洛落酪络骆
箫	嚣哮削宵硝销萧消	孝晓肖校小笑酵效学啸
箭	践建溅鉴渐健荐监件涧键舰间贱剑见	坚柬拣捡茧兼简尖检剪俭艰碱减煎歼肩奸
箱	相乡镶厢湘香	像橡项想祥向巷详享响翔象降
篇	偏翩扁	片遍骗便
篓	搂	露漏陋楼娄
篙	糕羔高膏	稿搅搞告
篡	窜
篮	拦蓝澜栏兰	览懒榄缆烂揽滥
篱	离犁厘黎漓狸梨丽璃	李理隶沥礼励历莉吏立砾雳痢粒厉哩力荔例俐利里鲤栗
篷	棚膨硼鹏澎蓬朋彭	捧碰烹砰
簇	错促趋卒趣醋	粗
簸	跛薄播	泊渤搏勃剥伯菠卜拨荸般脖膊舶柏白博驳玻
簿	埠步怖部布不	捕补哺卜
籍	辑即吃棘脊唧借急嫉击级寂集及圾吉极疾	纪叽妓稽给荠记几迹既鲫基饥箕继奇济挤积寄畸冀骑讥际激绩居祭机季剂系计技忌肌其己鸡期
米	靡	咪密弥蜜秘迷谜觅泌糜
类	累泪擂	垒儡勒蕾雷
籽	仔滓子紫	资滋自字姿吱咨
粉		愤粪奋分份忿纷吩焚芬氛坟
粒	立吏砾雳丽痢隶沥励厉力荔历莉例俐利栗	李离礼犁厘理哩黎篱狸梨漓璃里鲤
粗		卒错促醋趋趣簇
粟	缩肃宿塑诉素速溯	酥苏俗
粤	悦越阅耀岳药跃说乐钥月	约
粥	周州舟洲	昼肘咒皱帚轴宙
粪	愤奋分份忿	粉芬吩焚纷氛坟
粮	凉量良梁粱	两俩谅晾亮辆
粱	凉量良梁粮	两俩谅晾亮辆
粹	悴翠脆	催崔衰摧
精	鲸兢惊经睛荆茎京更晶	颈径境竞静阱景净井劲靖警敬竟镜
糊	壶狐葫胡蝴弧湖	许呼沪互戏唬户乎护虎忽
糕	羔篙高膏	稿搅搞告
糖	堂唐棠膛搪塘	淌躺趟烫倘汤
糙	操	草槽曹
糜	谜弥迷靡	密咪蜜米秘觅泌
糟	遭	皂蚤造灶早噪枣躁藻燥凿澡
糠	慷康	抗扛炕
糯	懦诺	挪娜
系	夕细隙戏	悉膝熙厘习畦息栖吸惜洗携晰熄析锡席行徙袭媳西喜牺昔犀稀嬉希溪蟋
系	纪际妓荠祭记季剂夕既计鲫戏继济技隙忌寄冀骑细	悉熙叽厘稽籍习给畦即吃棘惜脊唧借急几嫉锡迹徙基级寂集饥箕及奇媳西喜牺积挤希畸吉讥膝激绩辑居息栖吸洗携机晰熄析席击行袭圾昔肌其犀稀溪嬉蟋己鸡期极疾
紊	文问闻免	瘟吻蚊纹温稳
素	缩肃宿粟塑诉速溯	酥苏俗
索	锁琐所	缩唆嗦梭
紧	尽仅锦谨	津进金斤劲巾禁浸近今筋晋襟
紫	仔滓子籽	资滋自字姿吱咨
累	垒儡泪擂蕾雷类	勒
絮	叙畜绪恤酗序旭婿蓄续	许徐需虚须吁
繁	樊烦帆凡矾	返范犯泛番饭翻反贩
纠	九久酒揪鸠韭灸玖	就舅臼旧救疚究
红	宫虹宏弓共攻蚣躬工公鸿恭洪功供	汞巩烘哄贡轰拱矿
纤	嵌千迁欠牵签铅谦歉	浅干潜黔谴前钱钳遣
纤	鲜仙先掀	嫌馅衔弦险腺线涎舷癣闲贤县咸现显陷限铣献宪
约		悦越阅耀岳药粤跃说乐钥月
级	辑即籍吃棘脊唧借急嫉击寂集及圾吉极疾	纪叽妓稽给荠记几迹既鲫基饥箕继奇济挤积寄畸冀骑讥际激绩居祭机季剂系计技忌肌其己鸡期
纪	际妓荠祭季记剂系既计鲫继技济忌寄冀骑	叽稽给籍即吃棘脊唧借急几嫉迹基集级箕寂饥及奇挤积畸吉讥激绩辑居机击圾肌其己鸡期极疾
纫	赁认韧刃任	仁人儿忍
纬	委伟尾苇萎	为卫薇位喂伪尉维胃未味威违偎遗慰蔚微桅谓围唯危魏巍畏
纯	醇淳唇	春蠢
纱	砂沙煞杉杀	霎厦傻
纲	岗扛冈肛缸钢刚	港
纳	那钠呐捺娜	拿哪
纵	棕从综宗踪	总
纷	芬吩氛分	粉愤粪奋份忿焚坟
纸	只址征止指趾旨	植治致制直脂窒掷氏织帜执稚蜘之志智挚枝肢值职至支秩吱置汁芝知滞殖识质
纹	文闻蚊	免紊问瘟吻温稳
纺	访仿	芳房妨放坊肪方防
纽	钮扭	牛拗
线	现馅陷腺限献县宪	仙嫌显衔闲弦险掀先纤涎舷癣鲜铣贤咸
练	敛恋炼链	帘怜连脸镰莲联廉
组	祖阻诅	卒族租足
绅	伸信申深参身呻	沈甚审慎婶肾渗神
细	戏夕隙系	悉膝熙厘习畦息栖吸惜洗携晰熄析锡席行徙袭媳西喜牺昔犀稀嬉希溪蟋
织	只氏芝枝肢知蜘支之吱脂汁	址植治致制直窒掷征帜执稚志智挚值止纸趾职至秩置滞殖指识旨质
终	中忠盅衷钟	种肿众重仲
绊	拌扮半伴办瓣	班板扳搬颁版般斑
绍	少召哨	稍捎梢勺烧芍
绎	腋邑逸艺肄掖亦意抑义溢疫异役易忆翼衣益亿奕液毅译屹艾一议谊	夷疑医仪伊漪依已以倚椅乙遗移姨胰宜尾揖蛇蚁矣壹
经	鲸兢惊精睛荆茎京更晶	颈径境竞静阱景净井劲靖警敬竟镜
绑	膀榜	傍蚌梆旁谤帮磅棒邦
绒	溶荣蓉榕熔融容茸	冗
结	接节杰揭截阶竭街捷劫皆洁	届界介姊借解诫戒姐芥
绕		饶扰
绘	诲惠讳贿汇晦慧会溃秽	恢虫茴堕回挥辉毁徽悔灰蛔
给	济挤脊己几	纪妓叽即稽籍荠吃棘唧借记急嫉迹既鲫基集寂及饥箕继奇积寄畸冀吉骑讥际激绩辑居祭机季剂击系计技忌圾肌其鸡期极疾
络	劳烙洛落酪骆	箩萝锣骡牢裸姥老螺罗捞唠逻
绝	掘倔决觉角诀爵脚嚼
绞	侥较搅狡矫饺角剿脚缴	交椒轿叫觉蕉娇胶焦窖礁教校骄浇郊嚼
统	筒桶	彤桐铜痛同童通瞳
绢	倦眷圈卷	鹃捐身
绣	锈臭宿袖嗅秀	朽休修羞
继	际纪妓荠祭季记剂系既计鲫技济忌寄冀骑	叽稽给籍即吃棘脊唧借急几嫉迹基集级箕寂饥及奇挤积畸吉讥激绩辑居机击圾肌其己鸡期极疾
绩	激叽稽居唧机几迹基饥箕奇肌其积畸鸡期讥	纪妓即给籍荠吃棘脊借急记嫉既鲫级集寂及继济挤寄冀吉骑际辑祭季剂击系计技忌圾己极疾
绪	叙畜恤酗序絮旭婿蓄续	许徐需虚须吁
续	叙畜绪恤酗序絮旭婿蓄	许徐需虚须吁
绰		戳
绳		生牲乘升剩圣胜笙甥盛省声
维	为薇违围唯危微巍桅	委卫位喂胃未味威偎慰谓苇畏伪尉遗萎纬蔚伟尾魏
绵	眠棉	免冕娩勉面缅
绷	崩	蹦
绸	稠畴筹愁仇酬	臭抽丑
综	棕从宗踪纵	总
绽	栈暂战占站蘸颤	盏沾瞻崭毡斩展
绿	氯滤律虑率	侣履屡旅娄驴缕铝吕
缀	坠赘	锥椎追
缅	免冕勉娩	绵眠面棉
缆	览懒榄烂揽滥	拦蓝澜篮栏兰
缎	锻段断	短端
缓		唤环换幻痪宦焕涣欢还患
缔	的弟蒂递帝第地	笛抵嘀低嫡滴底涤敌芽
缕	侣履屡旅娄铝吕	氯滤律绿虑驴率
编	边鞭蝙	辫便辨辩遍变扁匾贬
缘	猿源辕原援园元袁员圆	远宛渊愿怨冤鸳院
缚	芙辐蝠浮福幅服俘袱符扶伏拂夫	妇赴腹麸付脯附赋斧父负甫敷傅咐肤抚俯府辅富复孵腐副
缝	奉凤逢讽冯	丰疯峰风封枫锋蜂
缠	单蝉馋	搀产阐铲掺
缤	宾滨彬濒	鬓
缨	莺婴鹦英应樱鹰	荧影营迎莹蝇映赢萤景颖硬盈
缩	梭唆肃宿粟塑诉素速嗦溯	锁琐所酥索俗苏
缭	聊撩疗辽寥潦燎僚嘹	了料
缰	将浆姜江僵疆	桨酱蒋强匠讲奖降
缴	侥较搅狡矫绞饺角剿脚	交椒轿叫觉蕉娇胶焦窖礁教校骄浇郊嚼
缸	扛岗纲冈肛钢刚	港
缺		怯鹊却确瘸雀壳
罐	观惯冠贯灌	馆管官棺关
网	往枉	旺忘妄王亡望汪
罕	喊	韩悍和函翰涵汗汉酣旱寒撼憾捍焊含
罗	箩萝锣骡螺逻	烙裸洛落酪络骆
罚	阀乏伐法筏	发
罢	爸霸脾伯耙啤疲皮坝吧	八巴屁芭疤叭辟靶捌把批拔否霹坏笆跋僻劈披扒匹被譬
罩	赵召兆照	昭嘲找招爪朝着沼
罪	醉最	嘴堆
置	智挚知致治滞帜识稚至制秩质志窒	址植直脂掷只氏征织执蜘之枝肢值止纸趾职支吱汁芝殖指旨
署	树黍术鼠薯曙蜀述束暑疏属数竖庶恕墅漱	梳殊枢输叔淑书蔬舒赎熟抒
羊	杨扬阳洋	鸯养样痒秧殃氧仰央漾
美	每	媒煤霉枚昧妹梅楣玫媚眉没
羔	糕篙高膏	稿搅搞告
羞	休修	锈臭宿袖嗅秀朽绣
群	裙
羹	更耕	耿梗埂
羽	予屿雨与语宇	于愈愉榆浴淤狱渔娱豫舆隅遇谷喻域逾裕玉尉育誉鱼寓欲愚御迂郁预吁芋
翁	嗡
翅	赤斥	匙弛驰池迟持吃尺嗤齿耻侈
翎	凌灵菱玲伶蛉铃龄陵零	岭另领令
翔	祥详降	像想向箱镶巷湘象橡相项乡厢享响香
翘	窍桥侨峭跷瞧撬憔壳乔俏	巧锹鹊敲悄雀
翠	悴脆粹	催崔衰摧
翩	偏篇扁	片遍骗便
翰	旱焊悍撼憾捍汗汉	罕韩喊寒和函涵含酣
翻	番帆	樊反返范犯烦繁饭凡泛矾贩
翼	腋邑逸艺肄掖亦意抑义溢疫异役易忆衣益亿奕液毅译绎屹艾一议谊	夷疑医仪伊漪依已以倚椅乙遗移姨胰宜尾揖蛇蚁矣壹
耀	悦越阅岳药拗粤跃说乐要钥月	侥摇么哟夭淆腰遥舀肴谣咬吆约邀窑姚妖
老	姥	劳烙牢酪捞唠络
考	拷烤	铐靠
者		宅遮摘折哲浙这着蔗辙
而	儿	尔耳饵贰二
耍		刷
耐	奈	奶乃
耕	羹更	耿梗埂
耗	浩镐号好	鹤壕毫嚎蒿豪
耘	云匀	晕酝陨允孕运蕴韵员
耙	爸霸爬扒伯罢坝	八靶巴跋捌把趴笆芭拔疤怕帕吧叭
耳	饵尔	二贰而儿
耸		宋诵颂送讼松
耻	齿侈尺	翅匙斥驰迟池赤持吃嗤弛
耽	单丹担	弹淡胆石氮蛋旦但诞
耿	梗埂	羹更耕
聂	镊孽	捏
聊	撩疗缭辽寥潦燎僚嘹	了料
聋	咙龙隆胧窿笼	拢垄
职	植值殖执直质掷	址治致制脂窒只氏征织帜稚蜘之志智挚枝肢止纸趾至支秩吱置汁芝知滞指识旨
联	帘怜连镰莲廉	恋练脸敛炼链
聘		频贫濒品拼
聚	巨剧距具拒俱惧炬句锯据足	拘鞠蛆沮居车橘驹矩举局菊
聪	葱从囱匆	丛
肃	缩宿粟塑诉素速溯	酥苏俗
肄	腋邑逸艺掖亦意抑义溢疫异役易忆翼衣益亿奕液毅译绎屹艾一议谊	夷疑医仪伊漪依已以倚椅乙遗移姨胰宜尾揖蛇蚁矣壹
肆	食四饲伺似赐寺	死司丝思斯撕嘶私
肉		柔揉蹂
肋	勒乐垃	了
肌	激绩叽稽居唧机几迹基饥箕奇其积畸鸡期讥	纪妓即给籍荠吃棘脊借急记嫉既鲫级集寂及继济挤寄冀吉骑际辑祭季剂击系计技忌圾己极疾
肖	效孝笑酵校啸	嚣晓哮削宵小硝箫销萧学消
肘	帚	昼舟周咒州粥皱洲轴宙
肚	渡堵杜睹镀度妒赌	牍督毒都读独
肛	扛岗纲冈缸钢刚	港
肝	干竿杆甘柑	感赶敢秆橄
肠	场长偿常尝裳	唱昌厂畅倡敞猖
股	凸古鼓滑贾骨谷	估沽辜家雇咕告顾姑孤故固
肢	只氏芝枝知织蜘支之吱脂汁	址植治致制直窒掷征帜执稚志智挚值止纸趾职至秩置滞殖指识旨质
肤	敷麸孵夫	妇赴辐浮缚腹符伏拂付脯附赋斧福父俘负袱甫芙傅蝠咐抚俯府辅富复幅服扶腐副
肥		啡菲非废费沸肺诽吠飞匪
肩	坚兼尖艰溅歼煎渐间监奸	践建鉴健涧拣捡键检碱贱箭柬简剪荐茧俭舰减见件剑
肪	防坊房妨	芳放访纺方仿
肮		昂
肯	垦恳啃
育	域裕玉愈尉誉浴寓欲芋御狱郁与豫预遇语吁谷喻	逾予雨屿迂于愉渔榆鱼娱舆隅愚羽淤宇
肴	侥摇淆遥谣窑姚	么耀夭哟舀腰药乐咬吆要拗钥邀妖
肺	废吠费沸	啡肥菲非诽飞匪
肾	慎甚渗	沈伸呻审婶信申绅深参身神
肿	种	中忠盅衷众重终钟仲
胀	丈涨长帐杖仗账障	彰掌樟张章
胁	鞋挟协携谐斜邪	骇屉谢屑写蟹卸契些泻楔歇解懈械血
胃	为卫谓位尉喂伪未味遗慰蔚魏畏	委伟尾薇苇违维围威偎萎纬唯危微巍桅
胆		诞弹单石氮旦耽担蛋丹但淡
背	卑臂贝被辈焙狈惫悲杯备碑倍	北
胎	苔	泰台太抬汰态
胖	般盘	旁膀潘叛磅螃判攀乓庞畔盼
胚	坏	陪培赔佩配沛
胜	生牲乘升剩圣笙盛甥声	绳省
胞	褒包苞	爆堡饱刨暴薄雹保豹宝抱报
胡	壶狐糊葫蝴弧湖	许呼沪互戏唬户乎护虎忽
胧	咙龙隆窿笼聋	拢垄
胯	跨	垮夸
胰	夷宜疑蛇遗仪一移姨谊	医艺肄意抑伊疫异漪忆翼衣益奕液毅屹艾依已议以倚腋邑逸掖椅乙亦义溢役易揖尾亿译绎蚁矣壹
胳	搁戈割哥鸽疙歌	阁合格革隔葛蛤各个
胶	交椒蕉娇焦礁教骄浇郊	矫侥搅狡轿叫觉绞饺角窖剿校脚较嚼缴
胸	凶匈汹兄	雄熊
能		泞
脂	只氏芝枝肢知织蜘支之吱汁	址植治致制直窒掷征帜执稚志智挚值止纸趾职至秩置滞殖指识旨质
脆	悴翠粹	催崔衰摧
脉	默漠麦磨墨卖末沫莫膜迈陌寞茉没	么蘑买摩埋抹魔摸摹模
脊	辑即给籍吃棘唧借急几嫉击级寂集及济圾挤己吉极疾	纪叽妓稽荠记迹既鲫基饥箕继奇积寄畸冀骑讥际激绩居祭机季剂系计技忌肌其鸡期
脏	藏葬	赃
脏	赃	藏葬
脐	只鳍枝旗棋畦奇齐其崎祈歧骑期	泣迄戚稽漆妻七气砌契凄企启栖欺柒起器乞弃汽溪岂
脑	恼	挠闹
脓	农浓	弄
脖	泊舶渤搏勃白柏伯博卜薄驳膊荸	剥跛簸玻播拨般菠
脚	侥矫狡倔绞诀绝掘搅觉决饺角缴剿爵较嚼	交椒轿叫蕉娇胶焦窖礁教校骄浇郊
脯	菩仆腐葡斧朴父抚蒲俯甫府辅	妇赴辐浮缚暴腹符麸伏拂付附瀑赋福俘负袱普扑芙夫敷傅蝠咐谱肤铺圃富复幅服浦孵扶副
脱	托拖	椭唾拓驮驼鸵妥
脸		帘恋怜连练敛炼镰莲联链廉
脾	皮疲罢啤	屁否匹霹批坏被譬僻劈披辟
腊	辣落蜡	拉喇啦
腋	邑逸艺肄掖亦意抑义溢疫异役易忆翼衣益亿奕液毅译绎屹艾一议谊	夷疑医仪伊漪依已以倚椅乙遗移姨胰宜尾揖蛇蚁矣壹
腐	斧父抚俯甫府辅脯	妇赴辐浮缚腹符麸伏拂付附赋福俘负袱夫芙敷傅蝠咐肤富复幅服孵扶副
腔	抢将呛枪	墙强
腕	玩惋万	顽娩碗宛丸豌完湾婉晚弯挽
腥	兴星猩	邢行型刑形醒性姓杏幸省
腮	塞	赛
腰	么夭哟吆要邀妖	侥摇耀药淆舀遥肴谣乐咬钥拗窑姚
腹	附妇赴傅赋富复咐父负副付	辐浮缚符麸伏拂脯福斧俘袱甫夫敷芙蝠肤抚俯府辅幅服孵扶腐
腺	现馅陷线限献县宪	仙嫌显衔闲弦险掀先纤涎舷癣鲜铣贤咸
腻	泥溺逆匿	你拟尼呢
腾	誊疼
腿		推退颓蜕
膀	旁榜螃庞绑	傍蚌梆谤胖帮磅棒乓邦
膊	泊舶渤搏勃白柏伯博卜脖薄驳荸	剥跛簸玻播拨般菠
膏	糕羔篙高	稿搅搞告
膘	标彪	表
膛	堂唐糖棠搪塘	淌躺趟烫倘汤
膜	默漠磨墨脉莫沫陌魔茉末蘑摩寞摹模没	抹摸么
膝	悉熙厘畦栖吸携晰析行西牺犀稀嬉希溪蟋	徙习戏息系袭细隙媳喜惜洗昔熄席锡夕
膨	棚硼鹏篷澎蓬朋彭	捧碰烹砰
膳	善单扇赡擅	闪衫山陕杉删珊
臀	囤屯	吞褪
臂	庇毙背毕贝辈弊焙币惫狈鄙避必备泌辟壁倍璧被闭比蔽碧	逼卑彼鼻匕悲杯笔北碑
臣	沈晨沉尘陈辰忱	趁称衬
自	字	资滋紫仔姿籽子吱滓咨
臭	锈宿袖嗅秀绣	酬稠羞绸畴筹丑休愁仇抽朽修
至	智挚知致治滞帜质识稚制秩置志窒	址植直脂掷只氏征织执蜘之枝肢值止纸趾职支吱汁芝殖指旨
致	智挚治制至秩置窒知滞帜识稚质志	址植直脂掷只氏征织执蜘之枝肢值止纸趾职支吱汁芝殖指旨
致	智挚治制至秩置窒知滞帜识稚质志	址植直脂掷氏征织执蜘之枝肢值止纸趾职支吱汁芝殖指旨
臼	就舅旧救疚究	九酒久揪鸠韭灸纠玖
舀	夭咬	侥摇么哟淆腰遥肴姚耀药拗歪外谣乐吆钥窑要邀妖
舅	就臼旧救疚究	九酒久揪鸠韭灸纠玖
舆	逾予愉于渔娱鱼榆隅愚	屿愈浴淤狱与豫遇羽语谷喻域裕雨玉尉育誉寓欲御迂郁预吁芋宇
舌	什蛇甚	社摄奢射舍叶拾涉赊赦设
舍		社摄甚舌什奢射蛇叶拾涉赊赦设
舍	社赦射叶拾涉摄设	甚舌什奢蛇赊
舒	疏殊枢梳输书蔬抒	术鼠曙束署暑属庶恕漱熟树黍叔薯述蜀赎淑数竖墅
舔		天恬填添甜田
舞	武伍捂侮午鹉五	无于务雾巫诬乌吴勿梧呜污芜悟亡屋恶蜈晤误物坞
舟	周州粥洲	昼肘咒皱帚轴宙
航	行杭吭
般	班剥胖扳搬颁菠播拨盘玻斑	半扮渤拌勃伯卜瓣薄判攀畔盼舶柏潘叛驳泊搏办簸脖膊伴板白版绊跛博荸
舰	践建溅鉴渐健荐监件涧键间贱剑见箭	坚柬拣捡茧兼简尖检剪俭艰碱减煎歼肩奸
舱	苍仓沧	藏
舵	踱堕惰跺驮度	躲朵夺多
舶	泊渤搏勃白柏伯博卜脖薄驳膊荸	剥跛簸玻播拨般菠
舷	嫌衔弦涎闲贤咸	仙现馅显掀险陷先腺纤线限铣癣鲜献县宪
船	传	喘串穿川
艇	挺	听庭蜓廷停亭厅
艘	骚搔	嫂扫
良	凉量粱梁粮	两俩谅晾亮辆
艰	坚兼尖溅歼煎渐间监肩奸	践建鉴健涧拣捡键检碱贱箭柬简剪荐茧俭舰减见件剑
色	塞瑟圾涩
艳	谚咽淹焰宴雁沿验研燕堰砚厌唁	严炎演颜奄延烟阎殷衍癌盐言眼掩
艺	腋邑逸肄掖亦意抑义溢疫异役易忆翼衣益亿奕液毅译绎屹艾一议谊	夷疑医仪伊漪依已以倚椅乙遗移姨胰宜尾揖蛇蚁矣壹
艾	碍艺肄意抑疫异忆翼衣益奕液爱毅屹一隘议谊腋邑逸掖亦义溢役易亿译绎	哀夷疑医仪伊唉漪依已以倚蔼椅乙矮哎遗壹移姨胰宜揖尾蛇埃蚁矣挨
节	竭杰截劫捷结洁	接揭皆阶届街界介姊借解诫戒姐芥
芋	域裕玉愈尉育誉浴寓欲御狱郁与豫预遇语吁谷喻	逾予雨屿迂于愉渔榆鱼娱舆隅愚羽淤宇
芍	勺	稍捎少梢烧绍召哨
芒	氓盲茫忙	莽
芙	辐蝠浮福幅服缚俘袱符扶伏拂夫	妇赴腹麸付脯附赋斧父负甫敷傅咐肤抚俯府辅富复孵腐副
芜	蜈无巫诬亡梧吴	于务伍雾午乌舞勿武五呜污悟屋恶晤误物坞捂侮鹉
芝	只氏枝肢知织蜘支之吱脂汁	址植治致制直窒掷征帜执稚志智挚值止纸趾职至秩置滞殖指识旨质
芥	届介界借解诫戒	接节杰竭截揭阶皆街劫捷姊结洁姐
芦	颅炉卢庐	露录鹿氯卤陆路鲁虏赂碌
芬	纷吩氛分	粉愤粪奋份忿焚坟
芭	八巴扒捌笆疤吧叭	爸靶霸把伯耙罢拔跋坝
芯	衅欣薪新辛信心锌	寻
花	华哗	豁化划桦画话滑猾
芳	坊方	房妨放访纺肪防仿
芹	勤擒秦琴禽	侵亲钦寝
芽	笛牙的蚜嘀嫡涯衙押涤敌	压弟抵鸭地鸦蒂轧雅呀讶低递亚帝滴底第哑缔
苇	委伟尾萎纬	为卫薇位喂伪尉维胃未味威违偎遗慰蔚微桅谓围唯危魏巍畏
苍	仓舱沧	藏
苏	酥	缩俗肃宿粟塑诉素速溯
苔	台胎抬	态泰汰太
苗	描瞄	庙秒妙渺藐
苛	磕科蝌棵刻颗	咳坷客课壳渴可克
苞	褒包胞	爆堡饱刨暴薄雹保豹宝抱报
苟	狗	勾钩沟垢购构句够
若	弱惹	热
苦		裤枯酷哭库窟
英	莺婴鹦应缨樱鹰	荧影营迎莹蝇映赢萤景颖硬盈
苹	萍平评屏坪冯瓶凭	乒
茁	卓浊灼拙着啄琢酌	桌捉
茂	贸冒帽貌	毛茅矛锚猫
范	泛犯贩饭	樊返矾繁烦帆番凡翻反
茄	佳加家夹嘉	切荚假钾挟价贾契稼甲怯颊窃嫁夏且架驾
茅	矛锚毛	贸冒猫貌帽茂
茉	默漠磨墨脉末沫莫膜陌寞没	么蘑摩魔抹摸摹模
茎	鲸兢惊精经睛荆京更晶	颈径境竞静阱景净井劲靖警敬竟镜
茧	柬拣捡检简俭剪减碱	践尖建鉴歼健监涧键兼贱肩箭溅渐荐坚艰舰煎间件剑见奸
茫	氓盲芒忙	莽
茴	回蛔	恢虫堕挥诲灰秽惠讳贿汇绘辉毁徽悔晦慧溃会
茵	因殷音姻阴	印瘾隐吟听银淫饮引蚓
茶	察查	刹岔叉喳差插
茸	溶荣绒冗蓉榕熔容融
荆	鲸兢惊精经睛茎京更晶	颈径境竞静阱景净井劲靖警敬竟镜
草		曹槽操糙
荐	践建溅鉴渐健监件涧键舰间贱剑见箭	坚柬拣捡茧兼简尖检剪俭艰碱减煎歼肩奸
荒	慌	黄恍谎皇晃煌凰幌惶蝗
荔	立吏砾雳丽痢隶沥粒励厉力历莉例俐利栗	李离礼犁厘理哩黎篱狸梨漓璃里鲤
荚	挟颊夹	佳钾加价架甲夏嘉驾家稼嫁贾假茄
荠	际纪妓祭季记剂系既计鲫继技济忌寄冀骑	叽稽给籍即吃棘脊唧借急几嫉迹基集级箕寂饥及奇挤积畸吉讥激绩辑居机击圾肌其己鸡期极疾
荡	挡当	铛裆档党
荣	溶绒蓉榕熔融容茸	冗
荤	昏婚	浑魂混
荧	营迎蝇赢萤莹盈	影莺鹦婴英应映缨樱景颖硬鹰
药	悦越阅耀岳拗粤跃说乐要钥月	侥摇么哟夭淆腰遥舀肴谣咬吆约邀窑姚妖
荷	合鹤贺核盖和何河喝禾吓盒赫褐	呵
荸	泊舶渤搏勃白柏伯博卜脖薄驳膊	剥跛簸玻播拨般菠
莉	立吏砾雳丽痢隶沥粒励厉力荔历例俐利栗	李离礼犁厘理哩黎篱狸梨漓璃里鲤
莫	默漠磨墨脉末沫膜陌寞茉没	么蘑摩魔抹摸摹模
莱	来	癞赖
莲	帘怜连镰联廉	恋练脸敛炼链
获	豁或货祸霍惑	活和伙火
莹	荧营迎蝇赢萤盈	影莺鹦婴英应映缨樱景颖硬鹰
莺	婴鹦英应缨樱鹰	荧影营迎莹蝇映赢萤景颖硬盈
莽		芒盲茫氓忙
菊	局鞠橘	聚蛆沮居车具俱炬举锯句据拘巨剧距拒驹惧矩足
菌	骏俊竣峻	窘君钧均龟军
菜	采	财材踩才猜裁彩睬
菠	剥播拨般玻	泊舶渤搏勃驳白柏伯跛博卜簸薄脖膊荸
菩	仆葡朴蒲脯	瀑浦谱暴铺圃普扑
菱	凌灵玲伶蛉铃陵龄翎零	岭另领令
菲	啡非诽飞匪	废费沸肺肥吠
萄	逃淘陶桃涛	套掏讨滔
萌	朦盟檬蒙	梦锰猛孟
萍	苹平评屏坪冯瓶凭	乒
萎	委伟尾苇威偎纬	为卫位喂维未胃味慰谓围巍畏薇伪尉违遗蔚微桅唯危魏
萝	箩锣骡螺罗逻	烙裸洛落酪络骆
萤	荧营迎蝇赢莹盈	影莺鹦婴英应映缨樱景颖硬鹰
营	荧迎蝇赢萤莹盈	影莺鹦婴英应映缨樱景颖硬鹰
萧	嚣哮削宵硝箫销消	孝晓肖校小笑酵效学啸
萨	飒	撒洒
落	蜡烙辣洛酪络腊骆	箩萝锣喇骡裸拉螺罗啦逻
葛	阁合革格隔蛤	搁戈割胳各鸽哥疙个歌
葡	菩仆朴蒲脯	瀑浦谱暴铺圃普扑
董	懂	东冻栋冬洞动
葫	壶狐胡糊蝴弧湖	许呼沪互戏唬户乎护虎忽
葬	脏藏	赃
葱	聪从囱匆	丛
葵	魁	傀窥愧盔溃亏
蒂	的弟递帝第地缔	笛抵嘀低嫡滴底涤敌芽
蒋	讲桨奖	将姜浆酱江僵强匠疆缰降
蒙	萌盟朦檬	梦锰猛孟
蒜	算	酸
蒲	菩仆葡朴脯	瀑浦谱暴铺圃普扑
蒸	丁正征筝怔症狰睁挣争	政整郑证拯
蒿		鹤壕浩镐号耗好嚎毫豪
蓄	叙畜绪恤酗序絮旭婿续	许徐需虚须吁
蓉	溶荣绒榕熔融容茸	冗
蓝	拦澜篮栏兰	览懒榄缆烂揽滥
蓬	棚膨硼鹏篷澎朋彭	捧碰烹砰
蔑	灭
蔓	漫幔慢曼	瞒蛮满馒
蔗	浙这宅	遮摘折哲着者辙
蔚	为卫谓位尉喂伪胃未味遗慰魏畏	委伟尾薇苇违维围威偎萎纬唯危微巍桅
蔬	疏殊枢梳输书舒抒	术鼠曙束署暑属庶恕漱熟树黍叔薯述蜀赎淑数竖墅
蔼	矮	哀碍爱哎埃艾隘挨唉
蔽	庇毙臂毕弊币必避辟泌壁碧璧闭比鄙	逼彼鼻匕笔
蕉	交椒娇胶焦礁教骄浇郊	矫侥搅狡轿叫觉绞饺角窖剿校脚较嚼缴
蕊		锐瑞
蕴	晕酝孕运韵员	陨允云耘匀
蕾	垒累儡	勒泪擂雷类
薄	泊渤搏勃伯卜簸脖膊舶白柏博雹播驳荸	爆宝剥堡饱跛报豹暴刨包苞玻保拨般褒抱菠胞
薇	为维围违唯危微巍桅	委卫位喂胃未味威偎慰谓苇畏伪尉遗萎纬蔚伟尾魏
薛	靴	削雪学穴血
薪	欣新辛锌芯	衅信寻
薯	暑黍鼠属数蜀署	术曙束书庶恕漱舒熟树梳叔述赎抒疏殊枢输淑竖蔬墅
藏	脏葬	仓苍赃舱沧
藐	秒渺	庙描妙瞄苗
藕	偶呕	欧区殴鸥
藻	澡蚤早枣	皂躁造糟灶噪遭燥凿
蘑	磨膜摩魔摹模	默漠么墨脉末沫莫寞陌抹摸茉没
蘸	栈暂战占站绽颤	盏沾瞻崭毡斩展
虎	许唬	沪狐互户葫忽胡湖壶呼戏乎护糊蝴弧
虏	鲁卤	露录卢鹿氯炉陆芦颅路庐赂碌
虐	疟
虑	氯滤律绿率	侣履屡旅娄驴缕铝吕
虚	须需吁	许徐绪叙畜恤酗序絮旭婿蓄续
虫	崇重	宠充冲
虫	贿重毁悔诲崇会	恢充茴堕惠宠讳晦冲汇挥回绘辉徽灰慧溃秽蛔
虱	狮失施诗师湿尸	拭提匙势室时屎使柿侍驶拾饰誓氏实食恃什示石十式史事射释适嗜硕逝是市士蚀世矢试视识始
虹	洪鸿红宏	汞轰哄烘
虽		随祟穗岁遂隧髓碎
虾	瞎	狭匣洽厦挟暇峡侠下夏吓霞斜辖
蚀	硕实提食什时石十拾射	拭匙势室施屎使柿侍驶饰誓狮氏诗恃示式史事释适嗜尸失逝是虱士市世矢试视识始师湿
蚁	尾椅乙矣已以倚	夷疑医艺肄意抑仪伊疫异漪忆翼衣益奕液毅屹艾一依议谊腋邑逸掖亦义溢遗移役易姨胰宜揖亿译绎蛇壹
蚂	码吗玛马	么蟆麻妈骂
蚊	文纹闻	免紊问瘟吻温稳
蚌	傍谤旁磅棒	梆膀帮榜邦绑
蚓	瘾引隐听饮	印吟淫银因殷茵音姻阴
蚕	残惭	惨参餐灿
蚜	牙涯衙押芽	压鸭鸦轧雅呀讶亚哑
蚣	宫弓共攻躬公工供恭功红	拱汞巩贡矿
蚤	澡藻早枣	皂躁造糟灶噪遭燥凿
蚪	斗抖陡	痘都读逗兜豆
蚯	丘龟秋	求仇球囚
蛀	助住注柱祝铸驻	朱贮煮蛛主猪拄筑术珠属轴竹烛逐诸嘱株
蛆	曲圈拘屈沮居车趋躯俱驹岖驱锯区	聚漆去具取炬举局巨橘矩趣足句据菊鞠剧距拒娶惧渠
蛇	夷宜甚疑舌什遗仪一移姨胰谊	医艺肄意抑伊拾涉疫异漪忆翼衣益奢液奕毅屹艾依赦已议射以倚腋邑逸掖椅乙亦义溢舍叶赊摄役易设社揖尾亿译绎蚁矣壹
蛉	凌灵菱玲伶铃陵龄翎零	岭另领令
蛋	诞弹石氮担旦但淡	单胆耽丹
蛔	茴回	恢虫堕挥诲灰秽惠讳贿汇绘辉毁徽悔晦慧溃会
蛙	挖洼	娃瓦袜
蛛	朱猪珠诸株	助贮煮住注主柱筑术祝属铸轴拄竹烛蛀嘱驻逐
蛤	阁合革格隔葛	搁戈割胳各哥鸽哈疙个歌
蛮	漫瞒馒	满曼幔慢蔓
蛹	泳踊拥咏勇永	庸用佣
蛾	额讹鹅俄	噩阿愕饿遏哑鳄恶扼
蜀	暑黍鼠属薯数署	术曙束书庶恕漱舒熟树梳叔述赎抒疏殊枢输淑竖蔬墅
蜂	丰疯峰风封枫锋讽	奉凤缝逢冯
蜈	无芜巫诬亡梧吴	于务伍雾午乌舞勿武五呜污悟屋恶晤误物坞捂侮鹉
蜓	庭廷亭停	厅艇听挺
蜕	睡说退税	谁颓腿推水
蜗	瓜括刮	卦挂寡褂
蜘	只氏芝枝肢知织支之吱脂汁	址植治致制直窒掷征帜执稚志智挚值止纸趾职至秩置滞殖指识旨质
蜜	密秘觅泌	咪靡弥米迷谜糜
蜡	辣落腊	拉喇啦
蜻	氢倾卿顷轻清青	亲庆情擎请晴
蝇	荧营迎赢萤莹盈	影莺鹦婴英应映缨樱景颖硬鹰
蝉	单馋缠	搀产阐铲掺
蝌	磕苛科棵刻颗	咳坷客课壳渴可克
蝗	黄皇煌凰惶	恍谎荒慌晃幌
蝙	边鞭编	辫便辨辩遍变扁匾贬
蝠	芙辐浮福幅服缚俘袱符扶伏拂夫	妇赴腹麸付脯附赋斧父负甫敷傅咐肤抚俯府辅富复孵腐副
蝴	壶狐胡葫糊弧湖	许呼沪互戏唬户乎护虎忽
蝶	碟谍跌叠	爹
螃	膀庞旁	胖乓磅
融	溶荣绒蓉榕熔容茸	冗
螟	鸣铭明名	命
螺	箩萝锣骡罗逻	烙裸洛落酪络骆
蟀	硕帅烁数率勺	说摔甩衰
蟆	吗么麻	码玛马蚂妈骂
蟋	悉膝熙厘畦栖吸携晰析行西牺犀稀嬉希溪	徙习戏息系袭细隙媳喜惜洗昔熄席锡夕
蟹	骇屉谢屑卸契泻楔解懈械	鞋写挟协些携谐歇斜邪血胁
蠕	如儒软	女入辱褥乳
蠢		醇唇春淳纯
血	写穴雪削	靴骇屉屑鞋挟蟹携谐楔歇斜邪懈械胁谢协卸契些泻解薛学
衅	信芯	寻欣薪新辛心锌
行	悉邢熙膝杭刑厘畦栖吸携晰析形型航西牺吭犀稀嬉希溪蟋	习腥姓惜锡徙戏醒隙兴媳喜杏息星猩洗幸熄席系夕袭性昔省细
衍	眼掩演	谚咽炎淹焰艳颜奄延雁烟验沿堰癌厌砚唁严阎殷宴研燕盐言
衔	嫌弦舷涎闲贤咸	仙现馅显掀险陷先腺纤线限铣癣鲜献县宪
街	接揭皆阶结	节杰竭截届界介劫捷借解诫戒姊姐洁芥
衙	牙蚜涯押芽	压鸭鸦轧雅呀讶亚哑
衡	恒横	哼
衣	医艺肄意抑伊疫异漪忆翼益奕液毅屹艾一依议谊腋邑逸掖亦义溢役易揖亿译绎壹	姨夷宜尾疑椅乙矣遗仪蛇蚁移已胰以倚
补	捕哺卜	埠步不怖部布簿
表		标膘彪
衫	山杉删珊扇	闪陕善单赡擅膳
衬	趁称	沈臣晨沉尘陈辰忱
衰	催崔摔摧	悴蟀帅甩率翠脆粹
衷	中忠盅终钟	种肿众重仲
袁	猿源辕原援缘园元员圆	远宛渊愿怨冤鸳院
袄		澳懊傲拗熬奥凹
袋	贷戴带大待逮代怠	歹呆
袍	刨咆炮	跑泡抛
袒	毯坦	贪檀碳炭叹探谭潭弹瘫痰坛昙谈滩摊
袖	锈臭宿嗅秀绣	朽休修羞
袜		瓦洼蛙娃挖
被	匹臂背霹贝坏辈批焙狈惫备劈披倍	屁否卑脾罢啤皮疲杯譬悲僻北碑辟
袭	习息媳昔惜熄席锡	悉熙厘畦徙戏隙西喜牺希膝栖吸洗携晰析系行夕犀稀溪嬉蟋细
袱	芙辐蝠浮福幅服缚俘符扶伏拂夫	妇赴腹麸付脯附赋斧父负甫敷傅咐肤抚俯府辅富复孵腐副
裁	财才材	菜采踩猜彩睬
裂	列劣烈猎	咧
装	妆庄桩	壮撞状
裆	铛当	档挡荡党
裕	域玉愈尉育誉浴寓欲芋御狱郁与豫预遇语吁谷喻	逾予雨屿迂于愉渔榆鱼娱舆隅愚羽淤宇
裙	群
裤	库酷	窟枯苦哭
裳	场长偿常尝肠	唱昌上尚晌厂畅商倡敞汤猖赏伤
裸		箩萝锣骡烙洛落酪螺罗逻络骆
裹	果	锅国郭过
褂	卦挂	刮寡瓜蜗括
褐	合核盖和荷何河禾盒	鹤喝吓呵贺赫
褒	包苞胞	爆堡饱刨暴薄雹保豹宝抱报
褥	入辱	女蠕如乳儒
褪		吞囤臀屯
襟	津金斤巾禁浸今筋	进尽锦紧劲仅谨近晋
西	悉膝熙厘畦栖吸携晰析行牺犀稀嬉希溪蟋	徙习戏息系袭细隙媳喜惜洗昔熄席锡夕
见	践建溅鉴渐健荐监件涧键舰间贱剑箭	坚柬拣捡茧兼简尖检剪俭艰碱减煎歼肩奸
观	惯官棺冠贯罐灌关	馆管
规	傀归瑰龟闺	跪鬼诡桂柜贵轨
觅	密蜜秘泌	咪靡弥米迷谜糜
视	拭势逝室是使柿侍市士世饰适誓试氏恃示式识事释嗜	提匙施时屎驶拾狮实诗食什石十史射尸失硕虱蚀矢始师湿
览	懒榄缆揽	拦蓝澜篮烂栏兰滥
觉	掘轿决倔叫角窖绝诀教校脚爵较嚼	矫侥搅狡椒交绞蕉饺娇胶焦剿礁骄浇郊缴
角	侥矫狡倔绞诀绝掘搅较觉决饺缴剿爵脚嚼	交椒轿叫蕉娇胶焦窖礁教校骄浇郊
解	骇屉屑蟹楔借戒懈械姐芥谢届卸契界介泻诫姊	鞋竭杰截谐劫歇邪洁接阶写协些节挟街携结斜胁揭捷皆血
触	矗畜处	锄储初楚橱除础厨雏出
言	炎颜阎延沿研癌盐严	淹谚咽唁演艳焰掩奄宴雁烟验殷衍燕堰眼厌砚
誉	域裕玉愈尉育浴寓欲芋御狱郁与豫预遇语吁谷喻	逾予雨屿迂于愉渔榆鱼娱舆隅愚羽淤宇
誊	疼腾
誓	拭势逝室是使柿侍市士世饰适试氏视恃示式识事释嗜	提匙施时屎驶拾狮实诗食什石十史射尸失硕虱蚀矢始师湿
警	颈井景阱	兢惊径境竞荆茎靖京竟镜鲸经精睛静净劲敬更晶
譬	僻屁辟	否匹脾霹啤批坏被罢疲皮劈披
计	际纪妓荠祭季记剂系既鲫继技济忌寄冀骑	叽稽给籍即吃棘脊唧借急几嫉迹基集级箕寂饥及奇挤积畸吉讥激绩辑居机击圾肌其己鸡期极疾
订	锭定钉	丁盯叮鼎顶
认	赁韧纫刃任	仁人儿忍
讥	激绩叽稽居唧机几迹基饥箕奇肌其积畸鸡期	纪妓即给籍荠吃棘脊借急记嫉既鲫级集寂及继济挤寄冀吉骑际辑祭季剂击系计技忌圾己极疾
讨		掏滔萄逃淘陶套桃涛
训	逊讯驯迅汛殉	巡寻旬勋询循
议	腋邑逸艺肄掖亦意抑义溢疫异役易忆翼衣益亿奕液毅译绎屹艾一谊	夷疑医仪伊漪依已以倚椅乙遗移姨胰宜尾揖蛇蚁矣壹
讯	逊训驯迅汛殉	巡寻旬勋询循
记	际纪妓荠祭季剂系既计鲫继技济忌寄冀骑	叽稽给籍即吃棘脊唧借急几嫉迹基集级箕寂饥及奇挤积畸吉讥激绩辑居机击圾肌其己鸡期极疾
讲	蒋桨奖	将姜浆酱江僵强匠疆缰降
讳	诲惠贿汇绘晦慧会溃秽	恢虫茴堕回挥辉毁徽悔灰蛔
讶	亚轧	牙压蚜鸭鸦雅呀涯衙押芽哑
许	唬虎	狐沪恤酗忽旭胡湖呼徐戏乎糊序絮婿续弧叙互畜绪户葫蓄壶需护虚须蝴吁
讹	额鹅蛾俄	噩阿愕饿遏哑鳄恶扼
论	仑轮抡伦沦
讼	宋诵颂送	耸松
讽	丰疯奉峰风封枫锋凤缝蜂	冯逢
设	社赦射舍叶拾涉摄	甚舌什奢蛇赊
访	纺仿	芳房妨放坊肪方防
诀	掘倔决觉角绝爵脚嚼
证	政正郑症挣	丁征整睁拯狰筝怔蒸争
评	苹萍平屏坪冯瓶凭	乒
诅	祖组阻	卒族租足
识	拭势室治致使柿侍制饰窒誓氏恃示帜式稚事志释适嗜智挚逝是市士至秩世置试视知滞质	址植提匙施时屎驶拾直脂掷狮只实征诗什食织石执十史蜘之射尸失肢枝硕值止纸趾职虱蚀支吱矢汁芝殖指旨始师湿
诈	炸栅乍	眨喳渣查扎闸
诉	缩肃宿粟塑素速溯	酥苏俗
诊	枕疹侦珍斟榛针贞真	阵震振镇
词	瓷雌祠辞慈磁	厕刺此伺差赐次
译	腋邑逸艺肄掖亦意抑义溢疫异役易忆翼衣益亿奕液毅绎屹艾一议谊	夷疑医仪伊漪依已以倚椅乙遗移姨胰宜尾揖蛇蚁矣壹
试	拭势逝室是使柿侍市士世饰适誓氏视恃示式识事释嗜	提匙施时屎驶拾狮实诗食什石十史射尸失硕虱蚀矢始师湿
诗	狮失施虱师湿尸	拭提匙势室时屎使柿侍驶拾饰誓氏实食恃什示石十式史事射释适嗜硕逝是市士蚀世矢试视识始
诚	呈成惩程城承乘盛橙澄	称秤撑逞
话	化划画桦华	豁花滑猾哗
诞	弹石氮担蛋旦但淡	单胆耽丹
诡	鬼轨	傀归跪规瑰龟桂柜闺贵
询	巡寻旬驯循	逊讯训勋迅汛殉
该		概丐改溉盖钙
详	祥翔降	像想向箱镶巷湘象橡相项乡厢享响香
诫	届介界借解戒芥	接节杰竭截揭阶皆街劫捷姊结洁姐
诬	蜈吴于无芜巫亡梧乌屋呜污恶	舞务伍勿雾晤误物坞悟捂侮午五鹉武
语	域裕雨屿予玉愈尉育誉浴寓欲芋御狱郁与豫预遇羽吁谷宇喻	逾迂于愉渔榆娱鱼舆隅愚淤
误	勿务晤雾物坞悟恶	无于伍巫诬午乌吴舞梧武五呜污芜亡屋蜈捂侮鹉
诱	佑又有幼右	忧幽尤悠犹游由邮友油优
诲	虫惠讳贿汇绘毁悔晦慧会溃秽	恢茴堕回挥辉徽灰蛔
说	悦越阅蜕耀岳药粤跃睡乐税钥月	谁蟀硕帅烁数约率勺水
诵	宋颂送讼	耸松
请	顷	亲氢庆倾卿情擎轻清蜻晴青
诸	朱蛛猪珠株	助贮煮住注主柱筑术祝属铸轴拄竹烛蛀嘱驻逐
诺	糯懦	挪娜
读	牍痘毒斗逗独豆	肚渡堵督杜都陡睹兜镀度妒蚪赌抖
诽	菲匪	啡非废费沸肺肥吠飞
课	克可刻客	磕苛咳坷科蝌棵壳渴颗
谁		睡说税蜕水
调	条钓掉吊	跳挑叼刁雕碉
谅	凉量晾亮辆	两俩良粮梁粱
谆	屯	准
谈	弹檀痰坛昙谭潭	贪瘫毯碳叹炭探滩袒坦摊
谊	夷疑艺肄意抑仪疫异忆翼衣益奕液毅屹艾一议腋邑逸掖亦义溢遗移姨役易胰宜亿译绎蛇	揖尾医椅乙矣依伊蚁壹已以倚漪
谋		某
谍	碟蝶跌叠	爹
谎	幌恍晃	黄荒皇慌煌凰惶蝗
谐	鞋挟协携斜邪胁	骇屉谢屑写蟹卸契些泻楔歇解懈械血
谒	页咽夜业叶射	爷野椰也冶
谓	为卫位尉喂伪胃未味遗慰蔚魏畏	委伟尾薇苇违维围威偎萎纬唯危微巍桅
谚	淹咽焰艳宴雁沿验研燕堰砚厌唁	严炎演颜奄延烟阎殷衍癌盐言眼掩
谜	弥迷靡糜	密咪蜜米秘觅泌
谢	骇屉屑蟹卸契泻楔解懈械	鞋写挟协些携谐歇斜邪血胁
谣	侥摇淆遥肴窑姚	么耀夭哟舀腰药乐咬吆要拗钥邀妖
谤	傍蚌旁磅棒	梆膀帮榜邦绑
谦	嵌千迁牵纤签铅	干浅潜欠黔谴前钱钳遣歉
谨	尽仅锦紧	津进金斤劲巾禁浸近今筋晋襟
谭	弹檀痰坛昙谈潭	贪瘫毯碳叹炭探滩袒坦摊
谱	圃普浦	菩瀑仆扑葡朴铺暴蒲脯
谴	浅遣	千前钱钳歉干嵌迁欠潜牵纤黔签铅谦
谷	域裕玉愈凸尉育誉浴寓欲鼓滑芋御骨狱股贾郁古与豫预遇语吁喻	沽屿于愉榆顾淤辜渔娱家舆隅雇姑羽逾估雨予鱼咕告愚孤迂故宇固
谷	骨股凸古鼓滑贾	估沽辜家雇咕告顾姑孤故固
豁	华或获货划桦祸滑猾霍惑哗	化和花伙画火活话
豆	斗逗痘读	都陡兜蚪抖
豌	弯湾	玩顽万腕碗宛娩丸完惋婉晚挽
象	像相橡项向乡巷	想祥箱镶厢详享响湘翔香降
豪	鹤壕号嚎毫	浩镐耗好蒿
豫	域裕玉愈尉育誉浴寓欲芋御狱郁与预遇语吁谷喻	逾予雨屿迂于愉渔榆鱼娱舆隅愚羽淤宇
豹	爆暴刨抱报	褒堡饱包薄雹苞保宝胞
豺	柴	差拆
貌	贸冒帽茂	毛茅矛锚猫
贝	臂背被辈焙狈惫备倍	卑悲杯北碑
贞	诊侦珍斟榛针真	阵振枕震疹镇
负	附妇赴傅赋富复咐父腹副付	辐浮缚符麸伏拂脯福斧俘袱甫夫敷芙蝠肤抚俯府辅幅服孵扶腐
贡	供共	弓攻公工红矿宫汞蚣躬巩恭功拱
财	才材裁	菜采踩猜彩睬
责	窄择债泽贼则祭寨	侧斋宅摘怎齐
贤	嫌衔弦舷涎闲咸	仙现馅显掀险陷先腺纤线限铣癣鲜献县宪
败	拜	白百摆
账	丈涨长帐胀杖仗障	彰掌樟张章
货	豁或获祸霍惑	活和伙火
质	智挚植致治值制职至秩直置窒掷知滞帜殖执识稚志	只氏址枝肢芝征织止指纸趾旨蜘支之吱脂汁
贩	饭犯泛范	樊返矾繁烦帆番凡翻反
贪	滩瘫探摊	弹檀毯痰坛碳叹昙炭谈袒谭坦潭
贫	频濒	品拼聘
贬	匾扁	辫蝙便辨辩遍变边鞭编
购	够构垢	苟勾沟钩狗句
贮	煮主嘱属拄	助朱住注蛛猪柱筑术珠祝铸轴竹烛蛀诸逐驻株
贯	观惯冠罐灌	馆管官棺关
贰	二	尔耳饵而儿
贱	践建溅鉴渐健荐监涧键舰间件剑见箭	坚柬拣捡茧兼简尖检剪俭艰碱减煎歼肩奸
贴	帖	铁
贵	桂跪柜	傀归规鬼瑰诡龟闺轨
贷	戴袋带大待逮代怠	歹呆
贸	貌冒帽茂	毛茅矛锚猫
费	废吠肺沸	啡肥菲非诽飞匪
贺	鹤和荷喝吓赫	合核盖何河禾呵盒褐
贼	窄择泽则责	怎侧
贾	凸钾价架甲鼓滑夏骨驾股古稼嫁假谷	估沽佳辜固荚加挟家雇咕颊顾告姑孤故夹嘉茄
贿	虫诲惠讳汇绘毁悔晦慧会溃秽	恢茴堕回挥辉徽灰蛔
赁	躏认韧纫刃吝任	凛临人忍淋鳞琳邻儿仁林磷
赂	露录鹿氯陆路碌	卢炉卤芦颅鲁庐虏
赃	脏	藏葬
资	姿滋咨吱	自字紫仔籽子滓
赊	奢	社甚舌赦什射舍蛇叶拾涉摄设
赋	附妇赴傅富复咐父腹负副付	辐浮缚符麸伏拂脯福斧俘袱甫夫敷芙蝠肤抚俯府辅幅服孵扶腐
赌	睹肚堵	牍渡督毒杜都读镀度妒独
赎	淑熟叔	树梳黍术鼠薯曙述蜀束署书抒暑疏殊枢输属数竖庶蔬恕墅漱舒
赏	上晌	尚商裳汤伤
赐	食厕四刺饲伺肆似次寺	死瓷私司丝词此思差斯慈雌撕祠辞嘶磁
赔	陪培	佩坏配胚沛
赖	癞	莱来
赘	坠缀	锥椎追
赚	传撰钻转	专砖
赛	塞	腮
赞	暂	咱
赠		憎增曾
赡	善单扇擅膳	闪衫山陕杉删珊
赢	荧营迎蝇萤莹盈	影莺鹦婴英应映缨樱景颖硬鹰
赤	翅斥	匙弛驰池迟持吃尺嗤齿耻侈
赦	社射舍叶拾涉摄设	甚舌什奢蛇赊
赫	鹤荷和喝吓贺	合核盖何河禾呵盒褐
走		奏揍骤
赴	附妇傅赋富复咐父腹负副付	辐浮缚符麸伏拂脯福斧俘袱甫夫敷芙蝠肤抚俯府辅幅服孵扶腐
赵	兆罩召照	昭嘲找招爪朝着沼
赶	感敢秆杆橄	干肝竿甘柑
起	岂启乞稽	泣迄戚漆畦脐妻七只鳍气奇砌契凄企祈骑枝旗栖欺歧柒器棋弃汽齐其溪崎期
趁	称衬	沈臣晨沉尘陈辰忱
超	钞抄剿	嘲潮吵朝炒巢
越	悦阅耀岳药粤跃说乐钥月	约
趋	曲圈屈蛆错促躯卒岖驱趣区醋簇	漆粗去取娶渠
趟	烫	淌躺堂唐糖棠膛倘汤搪塘
趣	去促漆错趋卒娶醋簇	曲圈屈蛆粗躯取岖驱区渠
足	聚巨剧距具拒俱卒惧炬句锯族据	拘鞠蛆沮居车阻诅租橘驹祖组矩举局菊
趴		爬扒怕耙帕
趾	只址征止指纸旨	植治致制直脂窒掷氏织帜执稚蜘之志智挚枝肢值职至支秩吱置汁芝知滞殖识质
跃	悦越阅耀岳药粤说乐钥月	约
跋	拔	八巴伯罢笆芭疤吧叭爸靶霸扒捌把耙坝
跌	碟谍蝶叠	爹
跑		刨炮袍咆泡抛
跛	簸	泊渤搏勃剥伯菠卜薄拨荸般脖膊舶柏白博播驳玻
距	聚巨剧具拒俱惧炬句锯据足	拘鞠蛆沮居车橘驹矩举局菊
跟	根
跨	胯	垮夸
跪	贵桂柜	傀归规鬼瑰诡龟闺轨
路	露录鹿氯陆赂碌	卢炉卤芦颅鲁庐虏
跳		条调挑
践	建溅鉴渐健荐监件涧键舰间贱剑见箭	坚柬拣捡茧兼简尖检剪俭艰碱减煎歼肩奸
跷	窍锹峭撬壳翘俏敲	巧桥侨瞧憔乔鹊悄雀
跺	踱堕舵惰驮度	躲朵夺多
踊	泳蛹拥咏勇永	庸用佣
踏	蹋塌	塔
踢	剔梯	屉体提涕啼惕剃替蹄堤题
踩	睬采彩	菜财材猜才裁
踪	综棕纵宗	从总
踱	堕舵惰跺驮度	躲朵夺多
蹂	柔揉	肉
蹄	题提啼堤	剔屉体涕梯惕剃替踢
蹈	道悼到稻盗倒导	叨刀岛祷捣
蹋	踏塌	塔
蹦		绷崩
蹬	瞪凳邓	等登灯
蹲	墩敦	囤吨盹盾顿钝
躁	皂造灶噪燥	蚤糟早枣遭藻凿澡
躏	赁吝	凛临淋鳞琳邻林磷
身	圈伸鹃信申绅捐深参呻	沈甚卷审婶慎倦眷肾渗绢神
躬	宫弓共攻蚣公工供恭功红	拱汞巩贡矿
躯	曲圈屈蛆趋岖驱区	漆去取娶趣渠
躯	驱	漆娶趣
躲	朵	夺踱堕舵惰多跺驮度
躺	淌倘	堂趟唐糖烫棠膛汤搪塘
车	拘蛆沮居俱驹锯	扯聚具彻炬举局巨橘矩辙足撤澈句据菊鞠剧距拒惧
轧	讶亚	牙压蚜鸭价鸦雅呀涯衙押芽哑
轨	鬼诡	傀归跪规瑰龟桂柜闺贵
轩	喧宣	选炫漩玄悬旋还县
转	传撰赚	专砖
轮	仑抡伦论沦
软	蠕
轰	烘哄	虹宏汞鸿洪红
轴	术筑竹烛逐	舟朱周煮住猪咒珠州粥拄帚株昼肘助贮蛛注柱主祝洲皱属铸宙蛀诸嘱驻
轻	氢倾卿顷清蜻青	亲庆情擎请晴
载	仔宰在再	灾栽
轿	觉叫窖教校较	椒角胶娇脚嚼矫侥狡绞蕉焦郊搅交饺剿礁骄浇缴
较	侥矫狡轿叫绞窖教校搅觉饺角剿脚缴	交椒蕉娇胶焦礁骄浇郊嚼
辅	腐斧父抚俯甫府脯	妇赴辐浮缚腹符麸伏拂付附赋福俘负袱夫芙敷傅蝠咐肤富复幅服孵扶副
辆	凉量谅晾亮	两俩良粮梁粱
辈	臂背贝被焙狈惫备倍	卑悲杯北碑
辉	恢堕挥徽灰	虫茴惠晦讳贿汇回绘毁悔诲慧会溃秽蛔
辐	芙蝠浮福幅服缚俘袱符扶伏拂夫	妇赴腹麸付脯附赋斧父负甫敷傅咐肤抚俯府辅富复孵腐副
辑	即籍吃棘脊唧借急嫉击级集寂及圾吉极疾	纪叽妓稽给荠记几迹既鲫基饥箕继奇济挤积寄畸冀骑讥际激绩居祭机季剂系计技忌肌其己鸡期
输	疏殊枢梳书蔬舒抒	术鼠曙束署暑属庶恕漱熟树黍叔薯述蜀赎淑数竖墅
辕	猿源原援园缘元袁员圆	远宛渊愿怨冤鸳院
辖	狭匣洽挟暇峡侠霞斜	虾厦瞎下吓夏
辙	撤澈摘彻哲折	扯宅遮车浙这着蔗者
辛	欣薪新心锌芯	衅信寻
辜	估沽家咕姑孤	固股凸贾古雇鼓顾告滑故骨谷
辞	瓷词雌祠慈磁	厕刺此伺差赐次
辟	庇毙屁臂毕弊币必僻避泌壁碧璧闭比譬蔽鄙	逼否匹脾霹罢彼坏啤批匕被疲鼻皮劈披笔
辣	落蜡腊	拉喇啦
辨	辫便辩遍变	蝙扁匾边鞭编贬
辩	辫辨便变遍	蝙扁匾边鞭编贬
辫	辨便辩遍变	蝙扁匾边鞭编贬
辰	沈臣晨沉尘陈忱	趁称衬
辱	乳褥女入	如儒蠕
边	鞭编蝙	辫便辨辩遍变扁匾贬
辽	聊撩疗缭寥潦燎僚嘹	了料
达	答瘩	大搭打
迁	嵌千牵纤签铅谦	干浅潜欠黔谴前钱钳遣歉
迂	淤	屿于愈愉榆浴狱渔娱与豫舆隅遇语羽谷喻域逾裕雨予玉尉育誉鱼寓欲愚御郁预吁芋宇
迄	泣器气弃砌汽契企妻	戚稽畦漆脐七只鳍奇凄祈骑枝旗启栖欺起歧柒乞棋齐其溪崎岂期
迅	逊讯训驯汛殉	巡寻旬勋询循
过		锅裹果国郭
迈	脉卖麦	埋买
迎	荧营蝇赢萤莹盈	影莺鹦婴英应映缨樱景颖硬鹰
运	晕酝孕蕴韵员	陨允云耘匀
近	进尽劲仅禁浸晋	津金斤锦紧巾今谨筋襟
返	反	樊范犯烦繁帆番饭凡泛翻矾贩
还	环漩玄悬旋孩	喧缓唤骇害咳宣选炫换幻轩痪宦焕涣欢亥海患
进	尽劲仅禁浸近晋	津金斤锦紧巾今谨筋襟
远	愿院怨	猿源宛原援园冤元鸳圆辕渊缘袁员
违	为薇维围唯危微巍桅	委卫位喂胃未味威偎慰谓苇畏伪尉遗萎纬蔚伟尾魏
连	帘怜镰莲联廉	恋练脸敛炼链
迟	匙驰池持弛	翅斥赤吃尺嗤齿耻侈
迫	泊朴破魄	剖波颇坡婆泼
述	树疏术数竖曙庶束署恕墅漱	暑梳殊枢黍输鼠薯叔属蜀淑书蔬舒赎熟抒
迷	谜弥靡糜	密咪蜜米秘觅泌
迹	激绩叽稽居唧机几基饥箕奇肌其积畸鸡期讥	纪妓即给籍荠吃棘脊借急记嫉既鲫级集寂及继济挤寄冀吉骑际辑祭季剂击系计技忌圾己极疾
追	锥椎	坠缀赘
退	蜕	推颓腿
送	宋诵颂讼	耸松
适	拭势逝室是使柿侍市士世饰试誓氏视恃示式识事释嗜	提匙施时屎驶拾狮实诗食什石十史射尸失硕虱蚀矢始师湿
逃	萄淘陶桃涛	套掏讨滔
逆	泥腻溺匿	你拟尼呢
选		喧炫轩漩玄悬旋宣县
逊	讯训驯迅汛殉	巡寻旬勋询循
透		偷投头
逐	术筑轴竹烛	助朱贮煮住注猪主珠柱蛛祝属铸拄蛀诸嘱驻株
递	的弟蒂帝第地缔	笛抵嘀低嫡滴底涤敌芽
途	凸徒涂图突屠	土吐兔秃
逗	斗豆痘读	都陡兜蚪抖
通		统彤桐同铜桶痛筒童瞳
逛		广光
逝	拭势室是使柿侍市士世饰适誓试氏视恃示式识事释嗜	提匙施时屎驶拾狮实诗食什石十史射尸失硕虱蚀矢始师湿
逞		呈惩称成秤城诚程承乘撑盛橙澄
速	缩肃宿粟塑诉素溯	酥苏俗
造	皂躁灶噪燥	蚤糟早枣遭藻凿澡
逢	冯缝	丰疯奉峰风封枫锋凤讽蜂
逮	贷戴袋带大待代歹怠	呆
逸	腋邑艺肄掖亦意抑义溢疫异役易忆翼衣益亿奕液毅译绎屹艾一议谊	夷疑医仪伊漪依已以倚椅乙遗移姨胰宜尾揖蛇蚁矣壹
逻	箩萝锣骡螺罗	烙裸洛落酪络骆
逼		庇毙臂毕彼匕弊币必避辟泌壁碧璧闭鼻比笔蔽鄙
逾	予愉于渔娱鱼榆舆隅愚	屿愈浴淤狱与豫遇羽语谷喻域裕雨玉尉育誉寓欲御迂郁预吁芋宇
遂	祟穗岁隧碎	随髓虽
遇	域裕玉愈尉育誉浴寓欲芋御狱郁与豫预语吁谷喻	逾予雨屿迂于愉渔榆鱼娱舆隅愚羽淤宇
遍	片辫便辨辩变骗	偏蝙篇翩扁匾边鞭编贬
遏	噩愕俄饿恶鳄扼哑	阿额讹鹅蛾
道	悼到稻盗倒导蹈	叨刀岛祷捣
遗	夷卫为疑位喂伪尉胃未味仪移慰姨蔚胰宜谓谊蛇一魏畏	委医艺肄维意威抑偎伊疫异漪忆翼衣益奕液苇毅围屹艾依已议以巍倚腋邑薇逸掖椅乙违亦义溢萎纬役易微桅伟揖尾亿绎译唯蚁矣危壹
遣	浅谴	千前钱钳歉干嵌迁欠潜牵纤黔签铅谦
遥	侥摇淆肴谣窑姚	么耀夭哟舀腰药乐咬吆要拗钥邀妖
遭	糟	皂蚤造灶早噪枣躁藻燥凿澡
遮	着	宅摘折哲浙这蔗者辙
遵	尊	俊
避	庇毙臂毕弊币必辟泌壁碧璧闭比蔽鄙	逼彼鼻匕笔
邀	么夭哟腰吆要妖	侥摇耀药淆舀遥肴谣乐咬钥拗窑姚
邑	腋逸艺肄掖亦意抑义溢疫异役易忆翼衣益亿奕液毅译绎屹艾一议谊	夷疑医仪伊漪依已以倚椅乙遗移姨胰宜尾揖蛇蚁矣壹
邓	瞪凳蹬	等登灯
邢	行形刑型	醒腥星性兴姓猩杏幸省
那	钠哪呐纳捺娜	拿
邦	傍梆帮	蚌谤旁膀榜磅棒绑
邪	鞋挟协携谐斜胁	骇屉谢屑写蟹卸契些泻楔歇解懈械血
邮	尤由犹游油	佑忧幽悠友又诱有幼优右
邻	临淋鳞琳林磷	凛赁吝躏
郁	域裕玉愈尉育誉浴寓欲芋御狱与豫预遇语吁谷喻	逾予雨屿迂于愉渔榆鱼娱舆隅愚羽淤宇
郁	域裕玉愈尉育誉浴寓欲芋御狱豫预遇语吁谷喻	逾予雨屿迂于愉渔榆鱼娱舆隅愚羽淤宇
郊	交椒蕉娇胶焦礁教骄浇	矫侥搅狡轿叫觉绞饺角窖剿校脚较嚼缴
郎	狼琅榔廊	浪朗
郑	政正症证挣	丁征整睁拯狰筝怔蒸争
部	埠步簿怖布不	捕补哺卜
郭	锅	过果国裹
都	督兜	牍肚渡堵毒杜读镀蚪赌豆抖痘斗陡逗睹度妒独
鄙	庇毙臂毕彼匕弊币必避辟泌壁璧闭比笔蔽碧	逼鼻
酌	卓浊茁灼拙着啄琢	桌捉
配	佩沛	陪培赔坏胚
酒	九久韭灸纠玖	就舅揪鸠臼旧救疚究
酗	叙畜绪恤序絮旭婿蓄续	许徐需虚须吁
酝	晕孕运蕴韵员	陨允云耘匀
酣	和	韩悍函翰涵汗汉罕旱喊寒撼憾捍焊含
酥	苏	缩俗肃宿粟塑诉素速溯
酪	劳烙洛落络骆	箩萝锣骡牢裸姥老螺罗捞唠逻
酬	稠绸畴筹愁仇	臭抽丑
酱	匠将强降	桨姜浆江蒋僵疆讲缰奖
酵	效孝肖笑校啸	嚣晓哮削宵小硝箫销萧学消
酷	裤库	窟枯苦哭
酸		蒜算
酿		娘
醇	淳唇纯	春蠢
醉	罪最	嘴堆
醋	错促趋卒趣簇	粗
醒	省	邢行型刑腥性星兴姓猩杏幸形
采	彩睬踩菜	财材猜才裁
采	睬踩彩	菜财材猜才裁
释	拭势逝室是使柿侍市士世饰适誓试氏视恃示式识事嗜	提匙施时屎驶拾狮实诗食什石十史射尸失硕虱蚀矢始师湿
里	李礼理哩鲤	立吏犁厘黎狸梨砾雳丽痢璃隶沥离粒励厉力荔历莉篱漓例俐利栗
重	中虫种众崇仲	充忠盅宠肿衷冲终钟
野	也冶	页咽爷夜业椰叶射谒
量	凉谅粱晾良亮辆梁粮	两俩
金	津斤巾禁浸今筋襟	进尽锦紧劲仅谨近晋
鉴	践建溅渐健荐监件涧键舰间贱剑见箭	坚柬拣捡茧兼简尖检剪俭艰碱减煎歼肩奸
针	诊侦珍斟榛贞真	阵振枕震疹镇
钉	丁盯锭叮定订	鼎顶
钓	掉吊调	雕刁叼碉
钙	溉丐概盖	该改
钝	囤吨盹盾顿	墩蹲敦
钞	抄剿超	嘲潮吵朝炒巢
钟	中忠盅衷终	种肿众重仲
钠	那呐纳捺娜	拿哪
钢	扛岗纲冈缸肛刚	港
钥	悦越阅耀岳药粤跃说乐要拗月	侥摇么哟夭淆腰遥舀肴谣咬吆约邀窑姚妖
钦	侵亲	勤擒秦琴禽寝芹
钧	均君龟军	菌窘骏峻竣俊
钩	勾沟句	苟垢购狗构够
钮	纽扭	牛拗
钱	干潜黔前钳	嵌浅千迁欠牵纤签谴铅谦遣歉
钳	干潜黔前钱	嵌浅千迁欠牵纤签谴铅谦遣歉
钻	赚
钾	贾甲夏假	佳荚加挟价家茄稼颊嫁夹架嘉驾
铁	帖	贴
铃	凌灵菱玲蛉伶陵龄翎零	岭另领令
铅	嵌千迁牵纤签谦	干浅潜欠黔谴前钱钳遣歉
铆	柳	刘流榴陆硫留瘤溜泵六琉馏
铐	靠	考拷烤
铛	裆当	档挡荡党
铜	彤桐童同瞳	统筒桶痛通
铝	侣履屡旅娄缕吕	氯滤律绿虑驴率
铣	险显癣鲜	仙嫌馅衔弦先腺线涎舷闲贤县咸现掀陷纤限献宪
铭	鸣螟明名	命
铲	产阐	馋单蝉搀缠掺
银	吟淫	印瘾隐引听饮因殷蚓茵音姻阴
铸	助住注柱祝蛀驻	朱贮煮蛛主猪拄筑术珠属轴竹烛逐诸嘱株
铺	暴瀑仆扑	菩葡浦朴谱蒲圃普脯
链	敛恋炼练	帘怜连脸镰莲联廉
销	嚣哮削宵硝箫萧消	孝晓肖校小笑酵效学啸
锁	索琐所	缩唆嗦梭
锄	储橱除厨雏	矗畜初触楚处础出
锅	郭	过果国裹
锈	臭宿袖嗅秀绣	朽休修羞
锉	挫撮措错	搓
锋	丰疯峰风封枫讽蜂	奉凤缝逢冯
锌	欣薪新辛心芯	衅信寻
锐	瑞	蕊
错	锉促挫趋卒撮措趣醋簇	粗搓
锚	矛毛茅	贸冒猫貌帽茂
锡	习袭息媳昔惜熄席	悉熙厘畦徙戏隙西喜牺希膝栖吸洗携晰析系行夕犀稀溪嬉蟋细
锣	箩萝骡螺罗逻	烙裸洛落酪络骆
锤	捶垂椎	吹炊
锥	椎追	坠缀赘
锦	尽仅紧谨	津进金斤劲巾禁浸近今筋晋襟
锭	订定钉	丁盯叮鼎顶
键	践建溅鉴渐健荐监件涧舰间贱剑见箭	坚柬拣捡茧兼简尖检剪俭艰碱减煎歼肩奸
锯	聚蛆沮居车具俱炬句据拘巨剧距拒驹惧足	鞠橘矩举局菊
锰	猛	蒙萌梦孟檬朦盟
锹	跷敲撬	巧桥侨峭瞧憔壳乔俏悄窍翘鹊雀
锻	段缎断	短端
镀	肚渡杜度妒	牍堵督毒都读睹独赌
镇	阵震振枕	诊疹侦珍斟榛针贞真
镊	聂孽	捏
镐	浩号耗好	鹤壕毫嚎蒿豪
镜	径境竞静净劲敬靖竟	颈兢惊鲸经精睛阱荆茎井警京更景晶
镰	帘怜连莲联廉	恋练脸敛炼链
镶	相箱乡厢湘香	像橡项想祥向巷详享响翔象降
长	场丈涨掌帐胀偿常杖尝仗裳肠账障	唱彰昌厂樟畅倡敞猖张章
门	们	闷
闪	陕	衫山善杉单删扇珊赡擅膳
闭	庇毙臂毕弊币必避辟泌壁碧璧比蔽鄙	逼彼鼻匕笔
问	文紊闻免	瘟吻蚊纹温稳
闯	抢创	窗幢囱床疮撞
闰	润
闲	嫌衔弦涎舷贤咸	仙现馅显掀险陷先腺纤线限铣癣鲜献县宪
间	践尖建鉴溅歼健渐荐监坚涧件键兼艰舰奸煎见贱剑肩箭	柬拣捡茧检简俭剪碱减
闷		们门
闸	扎炸	眨诈栅乍喳查渣
闹		挠恼脑
闺	傀归规瑰龟	跪鬼诡桂柜贵轨
闻	免问紊蚊文纹	吻瘟温稳
闽	敏皿悯	民
阀	乏伐法罚筏	发
阁	合革格隔葛蛤	搁戈割胳各哥鸽疙个歌
阅	悦越耀岳药粤跃说乐钥月	约
阎	炎颜延沿研癌盐言严	淹谚咽唁演艳焰掩奄宴雁烟验殷衍燕堰眼厌砚
阐	铲产	馋单蝉搀缠掺
阔	扩括廓
队	兑对	堆
阱	颈警景井	兢惊径境竞荆茎靖京竟镜鲸经精睛静净劲敬更晶
防	肪坊房妨	芳放访纺方仿
阳	杨扬洋羊	鸯养样痒秧殃氧仰央漾
阴	因殷茵音姻	印瘾隐吟听银淫饮引蚓
阵	震镇振枕	诊疹侦珍斟榛针贞真
阶	接揭皆街结	节杰竭截届界介劫捷借解诫戒姊姐洁芥
阻	祖组诅	卒族租足
阿	啊	噩愕俄遏额哑恶饿讹鳄鹅蛾扼
附	妇赴傅赋富复咐父腹负副付	辐浮缚符麸伏拂脯福斧俘袱甫夫敷芙蝠肤抚俯府辅幅服孵扶腐
际	纪妓荠祭季记剂系既计鲫继技济忌寄冀骑	叽稽给籍即吃棘脊唧借急几嫉迹基集级箕寂饥及奇挤积畸吉讥激绩辑居机击圾肌其己鸡期极疾
陆	露录鹿氯溜路六赂碌馏	刘铆卢流炉榴卤硫留芦颅瘤柳泵鲁庐虏琉
陈	沈臣晨沉尘辰忱	趁称衬
陋	露漏	篓搂楼娄
陌	默漠磨墨脉末沫莫膜寞茉没	么蘑摩魔抹摸摹模
降	将酱祥强匠详翔	箱僵镶讲湘象相乡享响奖像想桨姜江蒋向巷疆橡项浆厢缰香
限	现馅陷腺线献县宪	仙嫌显衔闲弦险掀先纤涎舷癣鲜铣贤咸
陕	闪	衫山善杉单删扇珊赡擅膳
陡	蚪斗抖	痘都读逗兜豆
院	愿怨远	猿源宛原援园元冤鸳圆辕渊缘袁员
除	锄储橱厨雏	矗畜初触楚处础出
陨	允	晕酝孕云运蕴韵耘匀员
险	鲜显铣癣	仙嫌馅衔弦先腺线涎舷闲贤县咸现掀陷纤限献宪
陪	培赔	佩坏配胚沛
陵	凌灵菱玲伶蛉铃龄翎零	岭另领令
陶	萄逃淘桃涛	套掏讨滔
陷	现馅腺线限献县宪	仙嫌显衔闲弦险掀先纤涎舷癣鲜铣贤咸
隅	逾予愉于渔娱鱼榆舆愚	屿愈浴淤狱与豫遇羽语谷喻域裕雨玉尉育誉寓欲御迂郁预吁芋宇
隆	咙龙胧窿笼聋	拢垄
随		祟穗岁碎隧虽髓遂
隐	印瘾引听饮蚓	吟淫银因殷茵姻音阴
隔	阁合革格葛蛤	搁戈割胳各哥鸽疙个歌
隘	碍艾爱	哀蔼挨哎埃矮唉
隙	夕细戏系	悉膝熙厘习畦息栖吸惜洗携晰熄析锡席行徙袭媳西喜牺昔犀稀嬉希溪蟋
障	丈涨长帐胀杖仗账	彰掌樟张章
隧	祟穗岁碎遂	随髓虽
隶	立吏砾雳丽痢沥粒励厉力荔历莉例俐利栗	李离礼犁厘理哩黎篱狸梨漓璃里鲤
难	南男
雀	巧壳鹊怯确悄却	窍桥侨峭锹跷瞧撬憔乔翘俏缺敲瘸
雁	谚咽淹焰艳宴沿验研燕堰砚厌唁	严炎演颜奄延烟阎殷衍癌盐言眼掩
雄	熊	匈凶胸汹兄
雅	亚哑	牙压蚜鸭鸦轧呀讶涯衙押芽
集	辑即籍吃棘脊唧借急嫉击级寂及圾吉极疾	纪叽妓稽给荠记几迹既鲫基饥箕继奇济挤积寄畸冀骑讥际激绩居祭机季剂系计技忌肌其己鸡期
雇	估告顾故固	孤沽辜股凸古家咕鼓姑滑贾骨谷
雌	瓷词差祠辞慈磁	厕刺此伺赐次
雏	锄储橱除厨	矗畜初触楚处础出
雕	刁叼碉	钓掉吊调
雨	予屿与语羽宇	于愈愉榆浴淤狱渔娱豫舆隅遇谷喻域逾裕玉尉育誉鱼寓欲愚御迂郁预吁芋
雪	穴血削	靴薛学
雳	立吏砾丽痢隶沥粒励厉力荔历莉例俐利栗	李离礼犁厘理哩黎篱狸梨漓璃里鲤
零	凌灵菱玲伶蛉铃陵龄翎	岭另领令
雷	累擂	垒儡勒泪蕾类
雹	薄	爆褒宝堡饱刨暴苞保豹包抱报胞
雾	勿务晤误物坞悟恶	无于伍巫诬午乌吴舞梧武五呜污芜亡屋蜈捂侮鹉
需	须吁虚	许徐绪叙畜恤酗序絮旭婿蓄续
震	阵镇振枕	诊疹侦珍斟榛针贞真
霉	媒煤枚梅楣玫眉没	美每昧媚妹
霍	豁或获货祸惑	活和伙火
霎	厦煞	傻沙砂杉杀纱
霜	双	爽
霞	狭匣洽挟暇峡侠斜辖	虾厦瞎下吓夏
露	录漏鹿陋氯陆路赂碌	卢楼娄卤炉搂芦颅鲁庐虏篓
霸	爸伯罢耙坝	八靶巴跋扒捌把笆芭拔疤吧叭
霹	匹批坏被劈披	屁否脾罢啤疲譬皮僻辟
青	氢倾卿顷轻清蜻	亲庆情擎请晴
靖	径境竞静净劲敬竟镜	颈兢惊鲸经精睛阱荆茎井警京更景晶
静	径境竞净劲敬靖竟镜	颈兢惊鲸经精睛阱荆茎井警京更景晶
非	菲啡飞	废费沸肺诽吠肥匪
靠	铐	考拷烤
靡	弥米迷谜糜	密咪蜜秘觅泌
面		免冕棉眠娩绵勉缅
革	阁合格隔葛蛤	搁戈割胳哥鸽疙歌
靴	薛	削雪学穴血
靶	把	八巴伯罢笆芭疤跋吧叭爸霸扒捌耙拔坝
鞋	挟协携谐斜邪胁	骇屉谢屑写蟹卸契些泻楔歇解懈械血
鞍	安庵氨	按案暗岸俺
鞠	局橘菊	聚蛆沮居车具俱炬举锯句据拘巨剧距拒驹惧矩足
鞭	边编蝙	辫便辨辩遍变扁匾贬
韧	赁认纫刃任	仁人儿忍
韩	寒函涵汗含	罕旱悍喊和翰撼憾捍焊汉酣
韭	九酒久灸纠玖	就舅揪鸠臼旧救疚究
音	因殷茵姻阴	印瘾隐吟听银淫饮引蚓
韵	晕酝孕运蕴员	陨允云耘匀
页	咽夜业叶射谒	爷野椰也冶
顶	鼎	丁盯钉锭叮定订
顷	氢清倾卿轻请蜻青	亲庆情擎晴
项	像相橡向乡巷象	想祥箱镶厢详享响湘翔香降
顺	瞬	吮盾
须	需吁虚	许徐绪叙畜恤酗序絮旭婿蓄续
顽	玩完丸	万腕碗娩宛豌惋湾婉晚弯挽
顾	估雇告故固	孤沽辜股凸古家咕鼓姑滑贾骨谷
顿	囤吨盹盾钝	墩蹲敦
颁	班扳搬般斑	拌扮半伴板版绊办瓣
颂	宋诵送讼	耸松
预	域裕玉愈尉育誉浴寓欲芋御狱郁与豫遇语吁谷喻	逾予雨屿迂于愉渔榆鱼娱舆隅愚羽淤宇
颅	芦炉卢庐	露录鹿氯卤陆路鲁虏赂碌
领	岭	凌灵另菱令玲伶蛉铃陵龄翎零
颇	剖	泊泼朴魄坡破波婆迫
颈	警景井阱	兢惊径境竞荆茎靖京竟镜鲸经精睛静净劲敬更晶
颊	挟夹荚	佳钾加价架甲夏嘉驾家稼嫁贾假茄
频	贫濒	品拼聘
颓		推退腿蜕
颖	影景	鹦婴蝇应映缨赢萤硬荧莺营迎英樱莹盈鹰
颗	磕苛科蝌棵刻	咳坷客课壳渴可克
题	提蹄啼堤	剔屉体涕梯惕剃替踢
颜	炎阎延沿研癌盐言严	淹谚咽唁演艳焰掩奄宴雁烟验殷衍燕堰眼厌砚
额	俄鹅蛾讹	噩阿愕饿遏哑鳄恶扼
颠		碘店垫殿甸玷佃淀点奠电典惦
颤	栈暂战占站蘸绽	盏沾瞻崭毡斩展
风	丰疯峰封枫锋讽蜂	奉凤缝逢冯
飒	萨	撒洒
飘	漂	票瓢
飞	菲啡非	废费沸肺诽吠肥匪
食	硕提时饲蚀拾似寺实什四石十伺肆射赐	拭匙势室施屎丝使柿侍驶饰誓嘶私狮氏死诗恃示式史事撕释嗜适尸失逝是虱士思市世斯矢试视司识始师湿
餐	参	惭惨残灿蚕
饥	激绩叽稽居唧机几迹基箕奇肌其积畸鸡期讥	纪妓即给籍荠吃棘脊借急记嫉既鲫级集寂及继济挤寄冀吉骑际辑祭季剂击系计技忌圾己极疾
饭	泛犯贩范	樊返矾繁烦帆番凡翻反
饮	印隐引瘾听蚓	吟淫银因殷茵姻音阴
饰	拭势逝室是使柿侍市士世适誓试氏视恃示式识事释嗜	提匙施时屎驶拾狮实诗食什石十史射尸失硕虱蚀矢始师湿
饱	宝堡保	爆包刨暴薄雹苞豹褒抱报胞
饲	食四伺肆似赐寺	死司丝思斯撕嘶私
饵	耳尔	二贰而儿
饶		绕扰
饺	侥较搅狡矫绞角剿脚缴	交椒轿叫觉蕉娇胶焦窖礁教校骄浇郊嚼
饼	柄禀秉屏丙	冰兵病并
饿	噩愕俄遏恶鳄扼哑	阿额讹鹅蛾
馁	哪	内
馅	现陷腺线限献县宪	仙嫌显衔闲弦险掀先纤涎舷癣鲜铣贤咸
馆	管	观惯官棺冠贯罐灌关
馋	单蝉缠	搀产阐铲掺
馏	溜陆六	刘铆流榴硫留瘤柳泵琉
馒	漫瞒蛮	满曼幔慢蔓
首	守手	售收熟兽瘦受授寿
香	相箱乡镶厢湘	像橡项想祥向巷详享响翔象降
马	码蚂吗玛	么蟆麻妈骂
驮	踱堕舵惰跺度驼鸵	朵拖夺椭躲托唾脱拓多妥
驯	逊巡寻讯旬训询迅汛循殉	勋
驰	匙池迟持弛	翅斥赤吃尺嗤齿耻侈
驱	曲圈屈蛆趋躯岖区	漆去取娶趣渠
驳	泊舶渤搏勃白柏伯博卜薄脖膊荸	剥跛簸玻播拨般菠
驴		侣履屡氯滤律旅娄绿虑缕铝吕率
驶	屎使史始矢	拭提匙势室施时柿侍拾饰誓狮氏实诗恃什示石食十式事射释嗜适尸失逝硕是虱士蚀市世试视识师湿
驹	拘蛆沮居车俱锯	鞠聚巨剧距橘具拒惧炬举矩局句据菊足
驻	助住注柱祝铸蛀	朱贮煮蛛主猪拄筑术珠属轴竹烛逐诸嘱株
驼	驮鸵	拖椭托唾脱拓妥
驾	架价稼嫁贾假	佳荚钾挟加家甲颊夏夹嘉茄
骂		码玛吗么马蚂蟆麻妈
骄	交椒蕉胶焦礁教娇浇郊	矫侥搅狡轿叫觉绞饺角窖剿校脚较嚼缴
骆	烙洛落酪络	箩萝锣骡裸螺罗逻
骇	屉谢屑害蟹卸契泻楔解懈械亥	咳还鞋写挟协些携谐歇孩斜邪血胁海
验	谚咽淹焰艳宴雁沿研燕堰砚厌唁	严炎演颜奄延烟阎殷衍癌盐言眼掩
骏	竣俊峻菌	窘君钧均龟军
骑	纪妓畦荠脐记只既鳍鲫继奇济寄祈冀际枝旗祭季歧剂系计棋技忌齐其崎期	泣迄戚叽稽籍漆给即吃棘脊唧借急几妻嫉七迹基级气寂集饥箕及砌契挤积凄企畸吉讥激绩启辑居栖机欺柒起击器乞弃圾汽肌溪己岂鸡极疾
骗	片遍	偏便篇翩扁
骚	艘搔	嫂扫
骡	箩萝锣螺罗逻	烙裸洛落酪络骆
骤	奏揍	走
骨	股凸古鼓滑贾谷	估沽辜家雇咕告顾姑孤故固
髓		随祟穗岁遂隧虽碎
高	糕羔篙膏	稿搅搞告
鬓		缤滨彬濒宾
鬼	诡轨	傀归跪规瑰龟桂柜闺贵
魁	葵	傀窥愧盔溃亏
魂	浑混	昏荤婚
魄	泊朴破迫	剖波颇坡婆泼
魏	为卫谓位尉喂伪胃未味遗慰蔚畏	委伟尾薇苇违维围威偎萎纬唯危微巍桅
魔	磨蘑膜摩摹模	默漠么墨脉末沫莫寞陌抹摸茉没
鱼	逾予愉于渔娱榆舆隅愚	屿愈浴淤狱与豫遇羽语谷喻域裕雨玉尉育誉寓欲御迂郁预吁芋宇
鲁	虏卤	露录卢鹿氯炉陆芦颅路庐赂碌
鲜	仙显掀险先纤铣癣	嫌馅衔现弦陷腺线限涎舷献闲贤宪县咸
鲤	李礼理哩里	立吏犁厘黎狸梨砾雳丽痢璃隶沥离粒励厉力荔历莉篱漓例俐利栗
鲫	际纪妓荠祭季记剂系既计继技济忌寄冀骑	叽稽给籍即吃棘脊唧借急几嫉迹基集级箕寂饥及奇挤积畸吉讥激绩辑居机击圾肌其己鸡期极疾
鲸	经兢惊精睛荆茎京更晶	颈径境竞静阱景净井劲靖警敬竟镜
鳄	噩愕俄遏饿恶扼哑	阿额讹鹅蛾
鳍	只枝旗棋畦奇齐其崎脐祈歧骑期	泣迄戚稽漆妻七气砌契凄企启栖欺柒起器乞弃汽溪岂
鳖		别瘪
鳞	临淋琳邻林磷	凛赁吝躏
鸟		尿
鸠	揪纠	就九舅酒久韭灸臼疚救旧究玖
鸡	激绩叽稽居唧机几迹基饥箕奇肌其积畸期讥	纪妓即给籍荠吃棘脊借急记嫉既鲫级集寂及继济挤寄冀吉骑际辑祭季剂击系计技忌圾己极疾
鸣	铭螟明名	命
鸥	欧区殴呕	藕偶
鸦	押鸭压呀	牙蚜轧雅讶涯衙亚芽哑
鸭	押压鸦呀	牙蚜轧雅讶涯衙亚芽哑
鸯	央秧殃	阳羊养杨扬痒样氧仰洋漾
鸳	宛冤渊	远源猿辕原愿怨援缘园元袁院员圆
鸵	驮驼	拖椭托唾脱拓妥
鸽	搁戈割胳哥疙歌	阁合格革隔葛蛤各个
鸿	洪宏红虹	汞轰哄烘
鹃	圈捐身	倦眷卷绢
鹅	额讹蛾俄	噩阿愕饿遏哑鳄恶扼
鹉	武舞伍捂侮午五	无于务雾巫诬乌吴勿梧呜污芜悟亡屋恶蜈晤误物坞
鹊	巧壳怯确悄雀却	窍桥侨峭锹跷瞧撬憔乔翘俏缺敲瘸
鹏	棚膨硼篷澎蓬朋彭	捧碰烹砰
鹤	壕号和荷喝吓嚎毫贺赫豪	合浩镐盖耗何核河禾好呵盒蒿褐
鹦	莺婴英应缨樱鹰	荧影营迎莹蝇映赢萤景颖硬盈
鹰	莺婴鹦英应缨樱	荧影营迎莹蝇映赢萤景颖硬盈膺
鹿	露录氯陆路赂碌	卢炉卤芦颅鲁庐虏
麦	迈脉卖	埋买
麸	肤孵敷夫	妇赴辐浮缚腹符伏拂付脯附赋斧福父俘负袱甫芙傅蝠咐抚俯府辅富复幅服扶腐副
麻	蟆么	码玛吗马蚂妈骂
黄	皇煌凰惶蝗	恍谎荒慌晃幌
黍	暑鼠属薯数蜀署	术曙束书庶恕漱舒熟树梳叔述赎抒疏殊枢输淑竖蔬墅
黎	离犁厘篱狸梨漓丽璃	李理隶沥礼励历莉吏立砾雳痢粒厉哩力荔例俐利里鲤栗
黑	嘿
黔	干潜前钱钳	嵌浅千迁欠牵纤签谴铅谦遣歉
默	漠磨墨脉末沫莫膜陌寞茉没	么蘑摩魔抹摸摹模
鼎	顶	丁盯钉锭叮定订
鼓	股凸古滑贾骨谷	估沽辜家雇咕告顾姑孤故固
鼠	暑黍属薯数蜀署	术曙束书庶恕漱舒熟树梳叔述赎抒疏殊枢输淑竖蔬墅
鼻		庇毙臂毕彼匕弊币必避辟泌逼壁碧璧闭比笔蔽鄙
齐	斋枝旗畦摘脐歧只鳍棋奇其崎祈骑期	泣迄戚稽漆寨妻七窄气债砌契凄企启宅栖祭欺起柒器乞弃汽溪责岂
齿	耻侈尺	翅匙斥驰迟池赤持吃嗤弛
龄	凌灵菱玲伶蛉铃陵翎零	岭另领令
龙	咙隆胧窿笼聋	拢垄
龟	傀蚯归规君钧瑰均丘秋军闺	贵跪囚菌窘骏鬼峻诡桂柜求竣仇球俊轨